country;country_code;population;indicator;weekly_count_cases;weekly_count_death;year_week;rate_14_day_cases;rate_14_day_death;cumulative_count_cases;cumulative_count_death;death_general_men;death_general_woman;union_key;FirstDose;TargetGroup
Belgium;BEL;11566041;cases;0;0;2020-01;;0;0;0;1092;1142;Belgium2020-01;0;
Belgium;BEL;11566041;cases;0;0;2020-02;0;0;0;0;1187;1201;Belgium2020-02;0;
Belgium;BEL;11566041;cases;0;0;2020-03;0;0;0;0;1159;1155;Belgium2020-03;0;
Belgium;BEL;11566041;cases;0;0;2020-04;0;0;0;0;1072;1132;Belgium2020-04;0;
Belgium;BEL;11566041;cases;2;0;2020-05;0.017292002;0;2;0;1164;1192;Belgium2020-05;0;
Belgium;BEL;11566041;cases;1;0;2020-06;0.025938002;0;3;0;1086;1083;Belgium2020-06;0;
Belgium;BEL;11566041;cases;0;0;2020-07;0.008646001;0;3;0;1144;1163;Belgium2020-07;0;
Belgium;BEL;11566041;cases;0;0;2020-08;0;0;3;0;1109;1192;Belgium2020-08;0;
Belgium;BEL;11566041;cases;0;0;2020-09;0;0;3;0;1103;1146;Belgium2020-09;0;
Belgium;BEL;11566041;cases;0;0;2020-10;0;0;3;0;1076;1136;Belgium2020-10;0;
Belgium;BEL;11566041;cases;3678;0;2020-11;31.79999103;0;3681;0;1142;1092;Belgium2020-11;0;
Belgium;BEL;11566041;cases;3673;195;2020-12;63.55675205;16.8597016;7354;195;1268;1286;Belgium2020-12;0;
Belgium;BEL;11566041;cases;8130;783;2020-13;102.0487477;84.55788804;15484;978;1620;1578;Belgium2020-13;0;
Belgium;BEL;11566041;cases;9694;1584;2020-14;154.1063187;204.6508395;25178;2562;1981;2040;Belgium2020-14;0;
Belgium;BEL;11566041;cases;11175;1976;2020-15;180.4333912;307.7976293;36353;4538;2025;2267;Belgium2020-15;0;
Belgium;BEL;11566041;cases;7963;1666;2020-16;165.4671637;314.88735;44316;6204;1712;1991;Belgium2020-16;0;
Belgium;BEL;11566041;cases;5703;1186;2020-17;118.1562472;246.5839435;50019;7390;1386;1653;Belgium2020-17;0;
Belgium;BEL;11566041;cases;3095;696;2020-18;76.06751524;162.7177355;53114;8086;1105;1324;Belgium2020-18;0;
Belgium;BEL;11566041;cases;3051;533;2020-19;53.13832106;106.2593501;56165;8619;1138;1252;Belgium2020-19;0;
Belgium;BEL;11566041;cases;2071;312;2020-20;44.28481621;73.05870695;58236;8931;983;1059;Belgium2020-20;0;
Belgium;BEL;11566041;cases;1510;231;2020-21;30.96132895;46.94778447;59746;9162;1028;1054;Belgium2020-21;0;
Belgium;BEL;11566041;cases;1144;161;2020-22;22.94648618;33.89232322;60890;9323;969;1014;Belgium2020-22;0;
Belgium;BEL;11566041;cases;847;109;2020-23;17.21418764;23.34420222;61737;9432;823;976;Belgium2020-23;0;
Belgium;BEL;11566041;cases;671;57;2020-24;13.12462925;14.35236137;62408;9489;912;987;Belgium2020-24;0;
Belgium;BEL;11566041;cases;668;40;2020-25;11.5769951;8.386620798;63076;9529;898;924;Belgium2020-25;0;
Belgium;BEL;11566041;cases;607;40;2020-26;11.02365105;6.916800658;63683;9569;978;990;Belgium2020-26;0;
Belgium;BEL;11566041;cases;637;24;2020-27;10.75562502;5.533440526;64320;9593;871;897;Belgium2020-27;0;
Belgium;BEL;11566041;cases;704;11;2020-28;11.5942871;3.026100288;65024;9604;822;860;Belgium2020-28;0;
Belgium;BEL;11566041;cases;1385;18;2020-29;18.06149572;2.507340239;66409;9622;924;935;Belgium2020-29;0;
Belgium;BEL;11566041;cases;2489;14;2020-30;33.49460719;2.766720263;68898;9636;888;922;Belgium2020-30;0;
Belgium;BEL;11566041;cases;3759;21;2020-31;54.02021314;3.026100288;72657;9657;933;1014;Belgium2020-31;0;
Belgium;BEL;11566041;cases;4340;33;2020-32;70.02396066;4.668840444;76997;9690;999;1047;Belgium2020-32;0;
Belgium;BEL;11566041;cases;3751;74;2020-33;69.95479266;9.25122088;80748;9764;1323;1559;Belgium2020-33;0;
Belgium;BEL;11566041;cases;3453;41;2020-34;62.28578993;9.942900946;84201;9805;1101;1114;Belgium2020-34;0;
Belgium;BEL;11566041;cases;3121;24;2020-35;56.83880941;5.619900535;87322;9829;907;972;Belgium2020-35;0;
Belgium;BEL;11566041;cases;3655;18;2020-36;58.58530157;3.631320345;90977;9847;939;952;Belgium2020-36;0;
Belgium;BEL;11566041;cases;6158;17;2020-37;84.84320607;3.026100288;97135;9864;909;916;Belgium2020-37;0;
Belgium;BEL;11566041;cases;10108;27;2020-38;140.6358494;3.804240362;107243;9891;988;1016;Belgium2020-38;0;
Belgium;BEL;11566041;cases;11274;39;2020-39;184.8687896;5.706360543;118517;9930;931;985;Belgium2020-39;0;
Belgium;BEL;11566041;cases;18895;82;2020-40;260.8411988;10.461661;137412;10012;970;950;Belgium2020-40;0;
Belgium;BEL;11566041;cases;38852;140;2020-41;499.2806095;19.19412183;176264;10152;1035;1025;Belgium2020-41;0;
Belgium;BEL;11566041;cases;72232;238;2020-42;960.4323554;32.68188311;248496;10390;1115;1042;Belgium2020-42;0;
Belgium;BEL;11566041;cases;105383;505;2020-43;1535.659436;64.23978611;353879;10895;1314;1315;Belgium2020-43;0;
Belgium;BEL;11566041;cases;99584;1060;2020-44;1772.144851;135.3099129;453463;11955;1739;1543;Belgium2020-44;0;
Belgium;BEL;11566041;cases;54006;1435;2020-45;1327.939266;215.7177205;507469;13390;1849;1840;Belgium2020-45;0;
Belgium;BEL;11566041;cases;33967;1336;2020-46;760.6146304;239.5806828;541436;14726;1691;1741;Belgium2020-46;0;
Belgium;BEL;11566041;cases;22312;1131;2020-47;486.5882803;213.2968403;563748;15857;1597;1582;Belgium2020-47;0;
Belgium;BEL;11566041;cases;16261;882;2020-48;333.5021897;174.0439966;580009;16739;1418;1475;Belgium2020-48;0;
Belgium;BEL;11566041;cases;15289;700;2020-49;272.781326;136.779733;595298;17439;1304;1400;Belgium2020-49;0;
Belgium;BEL;11566041;cases;16840;665;2020-50;277.7873604;118.0179112;612138;18104;1392;1388;Belgium2020-50;0;
Belgium;BEL;11566041;cases;17714;654;2020-51;298.7539124;114.0407508;629852;18758;1364;1372;Belgium2020-51;0;
Belgium;BEL;11566041;cases;12607;536;2020-52;262.1553909;102.8874098;642459;19294;1273;1344;Belgium2020-52;0;
Belgium;BEL;11566041;cases;8976;454;2020-53;186.6066358;85.59540814;651435;19748;1188;1257;Belgium2020-53;0;ALL
Belgium;BEL;11566041;cases;13692;386;2021-01;195.9875466;72.62640691;665127;20134;1272;1209;Belgium2021-01;0;ALL
Belgium;BEL;11566041;cases;13093;342;2021-02;231.583132;62.94288599;678220;20476;1189;1219;Belgium2021-02;0;ALL
Belgium;BEL;11566041;cases;14641;373;2021-03;239.7881868;61.81890588;692861;20849;1218;1225;Belgium2021-03;4513;ALL
Belgium;BEL;11566041;cases;16375;293;2021-04;268.1643615;57.58236548;709236;21142;1225;1221;Belgium2021-04;0;ALL
Belgium;BEL;11566041;cases;14892;297;2021-05;270.3345077;51.01140485;724128;21439;1143;1140;Belgium2021-05;0;ALL
Belgium;BEL;11566041;cases;12527;279;2021-06;237.0646966;49.80096474;736655;21718;1106;1125;Belgium2021-06;433;ALL
Belgium;BEL;11566041;cases;15361;210;2021-07;241.1196709;42.27894402;752016;21928;1136;1186;Belgium2021-07;0;ALL
Belgium;BEL;11566041;cases;16648;170;2021-08;276.7498403;32.85480313;768664;22098;1055;1092;Belgium2021-08;518;ALL
Belgium;BEL;11566041;cases;16429;171;2021-09;285.9837692;29.4828628;785093;22269;968;1053;Belgium2021-09;0;ALL
Belgium;BEL;11566041;cases;21255;171;2021-10;325.815895;29.56932281;806348;22440;1094;1077;Belgium2021-10;60507;ALL
Belgium;BEL;11566041;cases;29329;178;2021-11;437.3493056;30.17454287;835677;22618;1055;1053;Belgium2021-11;0;ALL
Belgium;BEL;11566041;cases;33998;188;2021-12;547.5252941;31.64436301;869675;22806;1075;1040;Belgium2021-12;0;ALL
Belgium;BEL;11566041;cases;29873;256;2021-13;552.2287185;38.38824365;899548;23062;1182;1048;Belgium2021-13;0;ALL
Belgium;BEL;11566041;cases;24193;286;2021-14;467.4546805;46.86132446;923741;23348;1159;1060;Belgium2021-14;41264;ALL
Belgium;BEL;11566041;cases;24371;262;2021-15;419.8843839;47.38008451;948112;23610;1139;1034;Belgium2021-15;181071;ALL
Belgium;BEL;11566041;cases;24423;273;2021-16;421.8729641;46.2561044;972535;23883;1165;1057;Belgium2021-16;0;ALL
Belgium;BEL;11566041;cases;20783;254;2021-17;390.8511132;45.56442433;993318;24137;1165;1046;Belgium2021-17;289790;ALL
Belgium;BEL;11566041;cases;20975;255;2021-18;361.0397023;44.00814419;1014293;24392;1160;1105;Belgium2021-18;17010;ALL
Belgium;BEL;11566041;cases;14649;140;2021-19;308.0051333;34.15170325;1028942;24532;1069;1010;Belgium2021-19;189389;ALL
Belgium;BEL;11566041;cases;16999;129;2021-20;273.628634;23.25774221;1045941;24661;1021;1009;Belgium2021-20;0;ALL
Belgium;BEL;11566041;cases;12179;98;2021-21;252.273012;19.62642187;1058120;24759;1045;952;Belgium2021-21;32199;ALL
Belgium;BEL;11566041;cases;9065;84;2021-22;183.6756415;15.7357215;1067185;24843;1002;987;Belgium2021-22;60050;ALL
Belgium;BEL;11566041;cases;5261;50;2021-23;123.8626078;11.5856411;1072446;24893;994;887;Belgium2021-23;22765;ALL
Belgium;BEL;11566041;cases;3006;41;2021-24;71.4764888;7.867860749;1075452;24934;974;995;Belgium2021-24;50354;ALL
Belgium;BEL;11566041;cases;2416;23;2021-25;46.87861646;5.533440526;1077868;24957;907;874;Belgium2021-25;4306;ALL
Belgium;BEL;11566041;cases;4070;20;2021-26;56.07796134;3.717780354;1081938;24977;938;990;Belgium2021-26;33927;ALL
Belgium;BEL;11566041;cases;7513;10;2021-27;100.1466275;2.593800247;1089451;24987;893;932;Belgium2021-27;0;ALL
Belgium;BEL;11566041;cases;9541;7;2021-28;147.448898;1.46982014;1098992;24994;917;995;Belgium2021-28;18474;ALL
Belgium;BEL;11566041;cases;10388;11;2021-29;172.3061504;1.556280148;1109380;25005;978;1025;Belgium2021-29;39078;ALL
Belgium;BEL;11566041;cases;11283;21;2021-30;187.3674838;2.766720263;1120663;25026;933;954;Belgium2021-30;9648;ALL
Belgium;BEL;11566041;cases;12242;23;2021-31;203.3971694;3.804240362;1132905;25049;948;932;Belgium2021-31;0;ALL
Belgium;BEL;11566041;cases;13352;22;2021-32;221.2857451;3.89070037;1146257;25071;959;937;Belgium2021-32;26994;ALL
Belgium;BEL;11566041;cases;13831;41;2021-33;235.0242404;5.446980518;1160088;25112;949;891;Belgium2021-33;0;ALL
Belgium;BEL;11566041;cases;14116;32;2021-34;241.629785;6.3115806;1174204;25144;928;936;Belgium2021-34;85;ALL
Belgium;BEL;11566041;cases;13761;40;2021-35;241.0245649;6.225120592;1187965;25184;984;975;Belgium2021-35;0;ALL
Belgium;BEL;11566041;cases;13760;48;2021-36;237.9465886;7.608480724;1201725;25232;1030;987;Belgium2021-36;69;ALL
Belgium;BEL;11566041;cases;14475;39;2021-37;244.1198332;7.522020716;1216200;25271;974;925;Belgium2021-37;1217;ALL
Belgium;BEL;11566041;cases;13647;54;2021-38;243.1428351;8.040780765;1229847;25325;934;956;Belgium2021-38;49;ALL
Belgium;BEL;11566041;cases;13316;56;2021-39;233.1221202;9.510600905;1243163;25381;972;974;Belgium2021-39;1081;ALL
Belgium;BEL;11566041;cases;14922;62;2021-40;244.1457712;10.20228097;1258085;25443;990;1067;Belgium2021-40;0;ALL
Belgium;BEL;11566041;cases;22871;91;2021-41;326.7583091;13.22838126;1280956;25534;1121;1105;Belgium2021-41;4076;ALL
Belgium;BEL;11566041;cases;40000;108;2021-42;543.5827177;17.20554164;1320956;25642;1198;1141;Belgium2021-42;13268;ALL
Belgium;BEL;11566041;cases;54823;149;2021-43;819.839736;22.22022211;1375779;25791;1144;1187;Belgium2021-43;15381;ALL
Belgium;BEL;11566041;cases;57829;153;2021-44;973.9892847;26.11092248;1433608;25944;1142;1143;Belgium2021-44;0;ALL
Belgium;BEL;11566041;cases;73690;196;2021-45;1137.113382;30.17454287;1507298;26140;1224;1160;Belgium2021-45;20;ALL
Belgium;BEL;11566041;cases;113029;260;2021-46;1614.372628;39.42576375;1620327;26400;1250;1157;Belgium2021-46;1161;ALL
Belgium;BEL;11566041;cases;125774;297;2021-47;2064.690934;48.15822458;1746101;26697;1294;1198;Belgium2021-47;13;ALL
Belgium;BEL;11566041;cases;117316;350;2021-48;2101.75634;55.93962532;1863417;27047;1410;1324;Belgium2021-48;0;ALL
Belgium;BEL;11566041;cases;88873;310;2021-49;1782.710264;57.06360543;1952290;27357;1368;1242;Belgium2021-49;8;ALL
Belgium;BEL;11566041;cases;57114;250;2021-50;1262.203722;48.41760461;2009404;27607;1294;1248;Belgium2021-50;784;ALL
Belgium;BEL;11566041;cases;45149;218;2021-51;884.1659821;40.46328385;2054553;27825;1238;1197;Belgium2021-51;4;ALL
Belgium;BEL;11566041;cases;77857;155;2021-52;1063.509977;32.24958307;2132410;27980;1223;1232;Belgium2021-52;347;ALL
Belgium;BEL;11566041;cases;155821;130;2022-01;2020.38018;24.64110234;2288231;28110;1144;1207;Belgium2022-01;327;ALL
Belgium;BEL;11566041;cases;198811;139;2022-02;3066.148564;23.25774221;2487042;28249;1099;1120;Belgium2022-02;781;ALL
Belgium;BEL;11566041;cases;351691;175;2022-03;4759.640745;27.14844258;2838733;28424;1185;1179;Belgium2022-03;531;ALL
Belgium;BEL;11566041;cases;318844;231;2022-04;5797.446162;35.10276334;3157577;28655;1296;1224;Belgium2022-04;4725;ALL
Belgium;BEL;11566041;cases;185898;301;2022-05;4363.999747;45.99672438;3343475;28956;1322;1310;Belgium2022-05;5;ALL
Belgium;BEL;11566041;cases;101736;320;2022-06;2486.883801;53.69166511;3445211;29276;1241;1310;Belgium2022-06;231;ALL
Belgium;BEL;11566041;cases;63176;269;2022-07;1425.829288;50.92494484;3508387;29545;1290;1154;Belgium2022-07;2;ALL
Belgium;BEL;11566041;cases;44833;161;2022-08;933.8459028;37.17780354;3553220;29706;1196;1098;Belgium2022-08;86;ALL
Belgium;BEL;11566041;cases;44578;117;2022-09;773.0475795;24.03588229;3597798;29823;1106;1053;Belgium2022-09;1;ALL
Belgium;BEL;11566041;cases;57236;138;2022-10;880.2839278;22.0473021;3655034;29961;1205;1209;Belgium2022-10;0;ALL
Belgium;BEL;11566041;cases;71940;132;2022-11;1116.855802;23.34420222;3726974;30093;1206;1179;Belgium2022-11;14;ALL
Belgium;BEL;11566041;cases;78599;158;2022-12;1301.560318;25.07340239;3805573;30251;1196;1193;Belgium2022-12;556;ALL
Belgium;BEL;11566041;cases;71586;163;2022-13;1298.499634;27.75366264;3877159;30414;1183;1314;Belgium2022-13;0;ALL
Belgium;BEL;11566041;cases;62832;166;2022-14;1162.178139;28.44534271;3939991;30580;1270;1263;Belgium2022-14;0;ALL
Belgium;BEL;11566041;cases;52569;167;2022-15;997.7571409;28.79118274;3992560;30747;1216;1206;Belgium2022-15;20;ALL
Belgium;BEL;11566041;cases;40206;123;2022-16;802.1327263;25.07340239;4032766;30870;1135;1186;Belgium2022-16;21;ALL
Belgium;BEL;11566041;cases;32659;108;2022-17;629.9908499;19.9722619;4065425;30978;1077;1106;Belgium2022-17;12;ALL
Belgium;BEL;11566041;cases;30751;83;2022-18;548.2429122;16.51386157;4096176;31061;1097;1132;Belgium2022-18;8;ALL
Belgium;BEL;11566041;cases;24771;69;2022-19;480.0432577;13.14192125;4120947;31130;974;1032;Belgium2022-19;489;ALL
Belgium;BEL;11566041;cases;16105;51;2022-20;353.4139296;10.37520099;4137052;31181;:;:;Belgium2022-20;7;ALL
Belgium;BEL;11566041;cases;9108;40;2022-21;217.9916187;7.867860749;4146160;31221;:;:;Belgium2022-21;7;ALL
Belgium;BEL;11566041;cases;5946;39;2022-22;130.1568964;6.83034065;4152106;31260;:;:;Belgium2022-22;0;ALL
Germany;DEU;83155031;cases;1;0;2020-01;;0;1;0;9337;9546;Germany2020-01;0;
Germany;DEU;83155031;cases;0;0;2020-02;0.001202573;0;1;0;9607;9801;Germany2020-02;0;
Germany;DEU;83155031;cases;0;0;2020-03;0;0;1;0;9431;9522;Germany2020-03;0;
Germany;DEU;83155031;cases;1;0;2020-04;0.001202573;0;2;0;9438;9389;Germany2020-04;0;
Germany;DEU;83155031;cases;10;0;2020-05;0.013228304;0;12;0;9871;9903;Germany2020-05;0;
Germany;DEU;83155031;cases;9;0;2020-06;0.022848888;0;21;0;9471;9567;Germany2020-06;0;
Germany;DEU;83155031;cases;5;0;2020-07;0.016836023;0;26;0;9869;9779;Germany2020-07;0;
Germany;DEU;83155031;cases;5;0;2020-08;0.012025731;0;31;0;9468;9485;Germany2020-08;0;
Germany;DEU;83155031;cases;140;0;2020-09;0.174373094;0;171;0;9520;9985;Germany2020-09;0;
Germany;DEU;83155031;cases;904;0;2020-10;1.255486274;0;1075;0;9755;9912;Germany2020-10;0;
Germany;DEU;83155031;cases;6437;16;2020-11;8.828088826;0.192411689;7512;16;9815;10034;Germany2020-11;0;
Germany;DEU;83155031;cases;22409;143;2020-12;34.68942246;1.912091164;29921;159;9806;9916;Germany2020-12;0;
Germany;DEU;83155031;cases;33974;553;2020-13;67.80467678;8.369908491;63895;712;9925;9753;Germany2020-13;0;
Germany;DEU;83155031;cases;36056;1350;2020-14;84.21619132;22.88496531;99951;2062;10487;10175;Germany2020-14;0;
Germany;DEU;83155031;cases;27138;1737;2020-15;75.99540189;37.12343033;127089;3799;10254;10248;Germany2020-15;0;
Germany;DEU;83155031;cases;17340;1637;2020-16;53.48804452;40.57481501;144429;5436;9665;9596;Germany2020-16;0;
Germany;DEU;83155031;cases;12355;1197;2020-17;35.71040699;34.08092049;156784;6633;9358;9199;Germany2020-17;0;
Germany;DEU;83155031;cases;7438;825;2020-18;23.80252856;24.31602725;164222;7458;8874;9046;Germany2020-18;0;
Germany;DEU;83155031;cases;6240;527;2020-19;16.4487943;16.25878776;170462;7985;8810;8841;Germany2020-19;0;
Germany;DEU;83155031;cases;4764;362;2020-20;13.23311394;10.69087449;175226;8347;8666;8335;Germany2020-20;0;
Germany;DEU;83155031;cases;3603;282;2020-21;10.06192878;7.7445705;178829;8629;8594;8569;Germany2020-21;0;
Germany;DEU;83155031;cases;3205;150;2020-22;8.187117386;5.195115615;182034;8779;8382;8394;Germany2020-22;0;
Germany;DEU;83155031;cases;2353;119;2020-23;6.683901062;3.234921529;184387;8898;8631;8631;Germany2020-23;0;
Germany;DEU;83155031;cases;2345;74;2020-24;5.649688231;2.320966004;186732;8972;8364;8237;Germany2020-24;0;
Germany;DEU;83155031;cases;4186;53;2020-25;7.854004648;1.527267785;190918;9025;8214;8187;Germany2020-25;0;
Germany;DEU;83155031;cases;3162;58;2020-26;8.836506837;1.334856095;194080;9083;8724;8569;Germany2020-26;0;
Germany;DEU;83155031;cases;2693;46;2020-27;7.04106526;1.250675981;196773;9129;8327;8130;Germany2020-27;0;
Germany;DEU;83155031;cases;2422;30;2020-28;6.151161197;0.913955525;199195;9159;8103;8039;Germany2020-28;0;
Germany;DEU;83155031;cases;3040;26;2020-29;6.568454048;0.673440913;202235;9185;8329;8208;Germany2020-29;0;
Germany;DEU;83155031;cases;3937;33;2020-30;8.390352233;0.709518105;206172;9218;8515;8372;Germany2020-30;0;
Germany;DEU;83155031;cases;4841;34;2020-31;10.55618631;0.80572395;211013;9252;8704;8729;Germany2020-31;0;
Germany;DEU;83155031;cases;6068;31;2020-32;13.1188695;0.781672488;217081;9283;8559;8911;Germany2020-32;0;
Germany;DEU;83155031;cases;7955;29;2020-33;16.86368201;0.721543835;225036;9312;9776;9944;Germany2020-33;0;
Germany;DEU;83155031;cases;9596;40;2020-34;21.10635976;0.829775411;234632;9352;8760;8799;Germany2020-34;0;
Germany;DEU;83155031;cases;8834;41;2020-35;22.16342148;0.974084178;243466;9393;8203;8453;Germany2020-35;0;
Germany;DEU;83155031;cases;8617;19;2020-36;20.98610245;0.721543835;252083;9412;8367;8422;Germany2020-36;0;
Germany;DEU;83155031;cases;9764;32;2020-37;22.1044954;0.61331226;261847;9444;8504;8651;Germany2020-37;0;
Germany;DEU;83155031;cases;12292;54;2020-38;26.52395139;1.034212831;274139;9498;8737;8818;Germany2020-38;0;
Germany;DEU;83155031;cases;13070;66;2020-39;30.49965792;1.443087671;287209;9564;8663;8783;Germany2020-39;0;
Germany;DEU;83155031;cases;15938;78;2020-40;34.8842393;1.731705205;303147;9642;8822;8792;Germany2020-40;0;
Germany;DEU;83155031;cases;26131;124;2020-41;50.59104602;2.429197579;329278;9766;8854;8647;Germany2020-41;0;
Germany;DEU;83155031;cases;42056;232;2020-42;81.99984917;4.28116009;371334;9998;8927;8827;Germany2020-42;0;
Germany;DEU;83155031;cases;74882;411;2020-43;140.6264884;7.732544769;446216;10409;9347;9241;Germany2020-43;0;
Germany;DEU;83155031;cases;111004;789;2020-44;223.5414956;14.43087671;557220;11198;9349;9235;Germany2020-44;0;
Germany;DEU;83155031;cases;125744;1238;2020-45;284.7067666;24.37615591;682964;12436;9528;9479;Germany2020-45;0;
Germany;DEU;83155031;cases;127858;1662;2020-46;304.9749329;34.87461871;810822;14098;10036;9691;Germany2020-46;0;
Germany;DEU;83155031;cases;128393;2131;2020-47;308.1605489;45.61359613;939215;16229;10273;9909;Germany2020-47;0;
Germany;DEU;83155031;cases;123149;2914;2020-48;302.4976324;60.66981083;1062364;19143;10656;10648;Germany2020-48;0;
Germany;DEU;83155031;cases;128359;3434;2020-49;302.4567449;76.33933778;1190723;22577;11238;11366;Germany2020-49;0;
Germany;DEU;83155031;cases;156303;4364;2020-50;342.3268521;93.77664714;1347026;26941;12023;11980;Germany2020-50;0;
Germany;DEU;83155031;cases;174676;5257;2020-51;398.0264285;115.699554;1521702;32198;12360;12364;Germany2020-51;0;
Germany;DEU;83155031;cases;138880;5790;2020-52;377.0739981;132.8482458;1660582;37988;12660;12894;Germany2020-52;15341;1_Age60+
Germany;DEU;83155031;cases;123070;5994;2020-53;315.0140128;141.7112093;1783652;43982;12631;12866;Germany2020-53;150743;1_Age60+
Germany;DEU;83155031;cases;145487;5748;2021-01;322.959413;141.2061286;1929139;49730;12436;12413;Germany2021-01;204152;1_Age60+
Germany;DEU;83155031;cases;118905;5261;2021-02;317.9506962;132.3912681;2048044;54991;12138;12365;Germany2021-02;285869;1_Age60+
Germany;DEU;83155031;cases;95541;4942;2021-03;257.8869822;122.6985292;2143585;59933;11951;12126;Germany2021-03;238483;1_Age60+
Germany;DEU;83155031;cases;78153;4193;2021-04;208.8797249;109.8550489;2221738;64126;11319;11326;Germany2021-04;197375;1_Age60+
Germany;DEU;83155031;cases;64579;3418;2021-05;171.6456579;91.52783552;2286317;67544;10854;10882;Germany2021-05;196735;1_Age60+
Germany;DEU;83155031;cases;50815;2724;2021-06;138.7697156;73.86203728;2337132;70268;10607;10325;Germany2021-06;287952;1_Age60+
Germany;DEU;83155031;cases;52436;2075;2021-07;124.1668709;57.7114811;2389568;72343;10290;10179;Germany2021-07;375448;1_Age60+
Germany;DEU;83155031;cases;56385;1722;2021-08;130.8652029;45.66169905;2445953;74065;9607;9346;Germany2021-08;459911;1_Age60+
Germany;DEU;83155031;cases;58420;1378;2021-09;138.0614;37.27976483;2504373;75443;9354;9087;Germany2021-09;606629;1_Age60+
Germany;DEU;83155031;cases;71390;1253;2021-10;156.1060088;31.63969718;2575763;76696;9255;9354;Germany2021-10;712475;1_Age60+
Germany;DEU;83155031;cases;92651;1128;2021-11;197.2712872;28.63326453;2668414;77824;9105;9231;Germany2021-11;667354;1_Age60+
Germany;DEU;83155031;cases;116348;1215;2021-12;251.3365668;28.17628677;2784762;79039;9395;9001;Germany2021-12;905869;1_Age60+
Germany;DEU;83155031;cases;110138;1382;2021-13;272.3659618;31.23082234;2894900;80421;9528;8967;Germany2021-13;949222;1_Age60+
Germany;DEU;83155031;cases;118282;1537;2021-14;274.6917381;35.10310759;3013182;81958;9487;9339;Germany2021-14;1993102;1_Age60+
Germany;DEU;83155031;cases;142099;1527;2021-15;313.1271757;36.84683853;3155281;83485;9854;9211;Germany2021-15;2214524;1_Age60+
Germany;DEU;83155031;cases;144807;1616;2021-16;345.0254261;37.79687124;3300088;85101;9883;9367;Germany2021-16;1943151;1_Age60+
Germany;DEU;83155031;cases;124830;1601;2021-17;324.2581919;38.68677531;3424918;86702;9932;9579;Germany2021-17;2103889;1_Age60+
Germany;DEU;83155031;cases;100980;1429;2021-18;271.5530225;36.43796369;3525898;88131;9969;9339;Germany2021-18;1680229;1_Age60+
Germany;DEU;83155031;cases;70821;1152;2021-19;206.6032541;31.03841065;3596719;89283;9496;9096;Germany2021-19;1098055;1_Age60+
Germany;DEU;83155031;cases;52720;939;2021-20;148.5670783;25.14580266;3649439;90222;9073;8720;Germany2021-20;705531;1_Age60+
Germany;DEU;83155031;cases;29901;702;2021-21;99.35778871;19.7342239;3679340;90924;8765;8400;Germany2021-21;512247;1_Age60+
Germany;DEU;83155031;cases;20690;479;2021-22;60.83937363;14.20238783;3700030;91403;9278;8886;Germany2021-22;487622;1_Age60+
Germany;DEU;83155031;cases;14069;292;2021-23;41.80023696;9.271838285;3714099;91695;8842;8568;Germany2021-23;404565;1_Age60+
Germany;DEU;83155031;cases;7279;238;2021-24;25.67252966;6.373637213;3721378;91933;9606;9443;Germany2021-24;331546;1_Age60+
Germany;DEU;83155031;cases;4850;140;2021-25;14.58600863;4.545726163;3726228;92073;8696;8491;Germany2021-25;338593;1_Age60+
Germany;DEU;83155031;cases;4381;99;2021-26;11.10095191;2.874149611;3730609;92172;8605;8384;Germany2021-26;283547;1_Age60+
Germany;DEU;83155031;cases;5585;62;2021-27;11.98484311;1.936142625;3736194;92234;8587;8370;Germany2021-27;198406;1_Age60+
Germany;DEU;83155031;cases;9110;57;2021-28;17.6718111;1.43106194;3745304;92291;8800;8827;Germany2021-28;152744;1_Age60+
Germany;DEU;83155031;cases;12641;69;2021-29;26.15716661;1.515242054;3757945;92360;8826;8758;Germany2021-29;110194;1_Age60+
Germany;DEU;83155031;cases;15520;48;2021-30;33.86565991;1.407010479;3773465;92408;8618;8588;Germany2021-30;88008;1_Age60+
Germany;DEU;83155031;cases;20426;59;2021-31;43.22769118;1.286753173;3793891;92467;8547;8454;Germany2021-31;76629;1_Age60+
Germany;DEU;83155031;cases;32070;77;2021-32;63.1302753;1.63549936;3825961;92544;8679;8856;Germany2021-32;81144;1_Age60+
Germany;DEU;83155031;cases;49651;130;2021-33;98.27547295;2.489326232;3875612;92674;8746;8703;Germany2021-33;78717;1_Age60+
Germany;DEU;83155031;cases;66395;163;2021-34;139.5537932;3.523539063;3942007;92837;8501;8664;Germany2021-34;74500;1_Age60+
Germany;DEU;83155031;cases;74745;271;2021-35;169.7311615;5.219167076;4016752;93108;8660;8678;Germany2021-35;65478;1_Age60+
Germany;DEU;83155031;cases;71667;329;2021-36;176.0711267;7.215438354;4088419;93437;9331;9501;Germany2021-36;57577;1_Age60+
Germany;DEU;83155031;cases;61477;436;2021-37;160.1153874;9.199683901;4149896;93873;9042;8970;Germany2021-37;59322;1_Age60+
Germany;DEU;83155031;cases;53612;414;2021-38;138.4029308;10.221871;4203508;94287;9169;8944;Germany2021-38;48922;1_Age60+
Germany;DEU;83155031;cases;56484;392;2021-39;132.3984835;9.692738855;4259992;94679;9121;8966;Germany2021-39;36726;1_Age60+
Germany;DEU;83155031;cases;58008;400;2021-40;137.6849947;9.524378627;4318000;95079;9166;9009;Germany2021-40;32612;1_Age60+
Germany;DEU;83155031;cases;65349;460;2021-41;148.3458048;10.34212831;4383349;95539;9508;9403;Germany2021-41;23760;1_Age60+
Germany;DEU;83155031;cases;97726;601;2021-42;196.1096016;12.75930016;4481075;96140;9875;9880;Germany2021-42;20860;1_Age60+
Germany;DEU;83155031;cases;137018;861;2021-43;282.2968102;17.58161812;4618093;97001;10134;10125;Germany2021-43;23181;1_Age60+
Germany;DEU;83155031;cases;177872;1199;2021-44;378.6782305;24.77300502;4795965;98200;10260;10058;Germany2021-44;22164;1_Age60+
Germany;DEU;83155031;cases;271182;1585;2021-45;540.0202424;33.47963396;5067147;99785;10510;10486;Germany2021-45;29368;1_Age60+
Germany;DEU;83155031;cases;351669;1991;2021-46;749.0238324;43.00401259;5418816;101776;11122;11133;Germany2021-46;37672;1_Age60+
Germany;DEU;83155031;cases;403330;2492;2021-47;907.941457;53.91135023;5822146;104268;11679;11481;Germany2021-47;58241;1_Age60+
Germany;DEU;83155031;cases;388174;2841;2021-48;951.8413865;64.13322124;6210320;107109;12302;11781;Germany2021-48;63106;1_Age60+
Germany;DEU;83155031;cases;338135;2652;2021-49;873.4396359;66.05733813;6548455;109761;12011;11882;Germany2021-49;56990;1_Age60+
Germany;DEU;83155031;cases;273575;2513;2021-50;735.6259659;62.1128985;6822030;112274;11479;11316;Germany2021-50;51461;1_Age60+
Germany;DEU;83155031;cases;193882;2039;2021-51;562.1511944;54.74112565;7015912;114313;11212;11112;Germany2021-51;25497;1_Age60+
Germany;DEU;83155031;cases;208736;1581;2021-52;484.1775599;43.53314474;7224648;115894;10969;11032;Germany2021-52;13041;1_Age60+
Germany;DEU;83155031;cases;338072;1250;2022-01;657.5765692;34.0448433;7562720;117144;10297;10375;Germany2022-01;18457;1_Age60+
Germany;DEU;83155031;cases;486016;944;2022-02;991.026027;26.38445291;8048736;118088;9990;9796;Germany2022-02;21400;1_Age60+
Germany;DEU;83155031;cases;796556;879;2022-03;1542.386533;21.92290687;8845292;118967;9933;9783;Germany2022-03;18903;1_Age60+
Germany;DEU;83155031;cases;1112847;904;2022-04;2296.196607;21.44187764;9958139;119871;10188;9884;Germany2022-04;15062;1_Age60+
Germany;DEU;83155031;cases;1292682;1074;2022-05;2892.824368;23.78689511;11250821;120945;10354;10206;Germany2022-05;9920;1_Age60+
Germany;DEU;83155031;cases;1310239;1326;2022-06;3130.202669;28.86175342;12561060;122271;10131;10207;Germany2022-06;7445;1_Age60+
Germany;DEU;83155031;cases;1193523;1559;2022-07;3010.956727;34.69423275;13754583;123830;10445;10551;Germany2022-07;5953;1_Age60+
Germany;DEU;83155031;cases;1092978;1527;2022-08;2749.684502;37.1114046;14847561;125357;10098;10155;Germany2022-08;6439;1_Age60+
Germany;DEU;83155031;cases;1131372;1519;2022-09;2674.943384;36.63037538;15978933;126876;10278;10295;Germany2022-09;7342;1_Age60+
Germany;DEU;83155031;cases;1407534;1481;2022-10;3053.219955;36.07719177;17386467;128357;10610;10392;Germany2022-10;6410;1_Age60+
Germany;DEU;83155031;cases;1578353;1608;2022-11;3590.747263;37.14748179;18964820;129965;10497;10575;Germany2022-11;4321;1_Age60+
Germany;DEU;83155031;cases;1584573;1770;2022-12;3803.649595;40.62291793;20549393;131735;10430;10518;Germany2022-12;4022;1_Age60+
Germany;DEU;83155031;cases;1291066;1652;2022-13;3458.165989;41.15205008;21840459;133387;10200;10416;Germany2022-13;3515;1_Age60+
Germany;DEU;83155031;cases;981624;1385;2022-14;2733.075765;36.5221438;22822083;134772;10495;10178;Germany2022-14;2698;1_Age60+
Germany;DEU;83155031;cases;777818;1213;2022-15;2115.857548;31.24284807;23599901;135985;9981;10051;Germany2022-15;1831;1_Age60+
Germany;DEU;83155031;cases;731251;965;2022-16;1814.765724;26.19204122;24331152;136950;9761;9603;Germany2022-16;1364;1_Age60+
Germany;DEU;83155031;cases;595791;780;2022-17;1595.864957;20.98489988;24926943;137730;9570;9416;Germany2022-17;3552;1_Age60+
Germany;DEU;83155031;cases;470958;618;2022-18;1282.843608;16.81197136;25397901;138348;9349;9473;Germany2022-18;1675;1_Age60+
Germany;DEU;83155031;cases;408808;481;2022-19;1057.98289;13.21627792;25806709;138829;9382;9442;Germany2022-19;1428;1_Age60+
Germany;DEU;83155031;cases;292477;285;2022-20;843.3464477;9.211709632;26099186;139114;:;:;Germany2022-20;1064;1_Age60+
Germany;DEU;83155031;cases;186390;209;2022-21;575.872553;5.940710911;26285576;139323;:;:;Germany2022-21;980;1_Age60+
Germany;DEU;83155031;cases;211035;63;2022-22;477.932598;3.27099872;26496611;139386;:;:;Germany2022-22;0;
Spain;ESP;47398695;cases;0;0;2020-01;;0;0;0;4392;4318;Spain2020-01;0;
Spain;ESP;47398695;cases;0;0;2020-02;0;0;0;0;4643;4755;Spain2020-02;0;
Spain;ESP;47398695;cases;2;0;2020-03;0.004219525;0;2;0;4895;5022;Spain2020-03;0;
Spain;ESP;47398695;cases;1;0;2020-04;0.006329288;0;3;0;5061;4893;Spain2020-04;0;
Spain;ESP;47398695;cases;2;0;2020-05;0.006329288;0;5;0;5005;4969;Spain2020-05;0;
Spain;ESP;47398695;cases;2;0;2020-06;0.008439051;0;7;0;4561;4631;Spain2020-06;0;
Spain;ESP;47398695;cases;4;1;2020-07;0.012658576;0.021097627;11;1;4467;4372;Spain2020-07;0;
Spain;ESP;47398695;cases;8;0;2020-08;0.025317153;0.021097627;19;1;4181;4232;Spain2020-08;0;
Spain;ESP;47398695;cases;129;0;2020-09;0.289037494;0;148;1;4288;4091;Spain2020-09;0;
Spain;ESP;47398695;cases;1423;24;2020-10;3.274351752;0.506343054;1571;25;4354;4111;Spain2020-10;0;
Spain;ESP;47398695;cases;11604;457;2020-11;27.48387904;10.14795871;13175;482;4872;4609;Spain2020-11;0;
Spain;ESP;47398695;cases;36404;2432;2020-12;101.285489;60.95104517;49579;2914;6900;5943;Spain2020-12;0;
Spain;ESP;47398695;cases;59359;5663;2020-13;202.037208;170.7852927;108938;8577;10518;9310;Spain2020-13;0;
Spain;ESP;47398695;cases;44422;5841;2020-14;218.9532855;242.7071041;153360;14418;10536;10431;Spain2020-14;0;
Spain;ESP;47398695;cases;30596;4766;2020-15;158.2701802;223.7825324;183956;19184;8169;9156;Spain2020-15;0;
Spain;ESP;47398695;cases;21248;3576;2020-16;109.3785388;175.9964067;205204;22760;6155;7089;Spain2020-16;0;
Spain;ESP;47398695;cases;14573;2386;2020-17;75.57381063;125.7840538;219777;25146;5047;5405;Spain2020-17;0;
Spain;ESP;47398695;cases;8100;1551;2020-18;47.8346503;83.06135855;227877;26697;4402;4606;Spain2020-18;0;
Spain;ESP;47398695;cases;5630;1069;2020-19;28.96704224;55.27578344;233507;27766;4107;4351;Spain2020-19;0;
Spain;ESP;47398695;cases;4887;611;2020-20;22.1883746;35.44401381;238394;28377;3795;3741;Spain2020-20;0;
Spain;ESP;47398695;cases;4421;454;2020-21;19.63767146;22.46897304;242815;28831;3811;3832;Spain2020-21;0;
Spain;ESP;47398695;cases;3832;340;2020-22;17.41187178;16.75151605;246647;29171;3890;3730;Spain2020-22;0;
Spain;ESP;47398695;cases;3035;242;2020-23;14.48774064;12.27881907;249682;29413;3641;3503;Spain2020-23;0;
Spain;ESP;47398695;cases;2356;164;2020-24;11.37373086;8.56563667;252038;29577;3466;3383;Spain2020-24;0;
Spain;ESP;47398695;cases;2207;115;2020-25;9.626847321;5.886238007;254245;29692;3481;3551;Spain2020-25;0;
Spain;ESP;47398695;cases;2366;62;2020-26;9.647944949;3.734280026;256611;29754;3736;3776;Spain2020-26;0;
Spain;ESP;47398695;cases;2814;47;2020-27;10.92857092;2.299641372;259425;29801;3777;3858;Spain2020-27;0;
Spain;ESP;47398695;cases;4880;29;2020-28;16.23251442;1.603419672;264305;29830;3881;3851;Spain2020-28;0;
Spain;ESP;47398695;cases;10318;25;2020-29;32.06417392;1.139271872;274623;29855;3745;3817;Spain2020-29;0;
Spain;ESP;47398695;cases;14681;50;2020-30;52.7419584;1.582322045;289304;29905;3967;3860;Spain2020-30;0;
Spain;ESP;47398695;cases;20469;89;2020-31;74.15815984;2.93257019;309773;29994;4201;4388;Spain2020-31;0;
Spain;ESP;47398695;cases;28349;153;2020-32;102.9943968;5.105625798;338122;30147;4008;4386;Spain2020-32;0;
Spain;ESP;47398695;cases;40219;209;2020-33;144.6622106;7.63734107;378341;30356;4100;4070;Spain2020-33;0;
Spain;ESP;47398695;cases;52178;311;2020-34;194.9357466;10.97076618;430519;30667;3997;3889;Spain2020-34;0;
Spain;ESP;47398695;cases;61172;395;2020-35;239.1416051;14.89492485;491691;31062;3971;3983;Spain2020-35;0;
Spain;ESP;47398695;cases;65514;515;2020-36;267.2774008;19.19884081;557205;31577;3986;3791;Spain2020-36;0;
Spain;ESP;47398695;cases;74102;684;2020-37;294.5566328;25.29605509;631307;32261;4085;3913;Spain2020-37;0;
Spain;ESP;47398695;cases;80912;840;2020-38;327.0427593;32.15278395;712219;33101;4098;4070;Spain2020-38;0;
Spain;ESP;47398695;cases;72591;890;2020-39;323.8549078;36.49889517;784810;33991;4246;3818;Spain2020-39;0;
Spain;ESP;47398695;cases;65190;946;2020-40;290.6852182;38.73524366;850000;34937;4308;3880;Spain2020-40;0;
Spain;ESP;47398695;cases;77828;953;2020-41;301.7340456;40.06439418;927828;35890;4432;4161;Spain2020-41;0;
Spain;ESP;47398695;cases;91265;1054;2020-42;356.7461087;42.34293792;1019093;36944;4530;4064;Spain2020-42;0;
Spain;ESP;47398695;cases;135554;1387;2020-43;478.5342719;51.49930816;1154647;38331;4849;4621;Spain2020-43;0;
Spain;ESP;47398695;cases;145244;1802;2020-44;592.4171541;67.28033335;1299891;40133;4960;4636;Spain2020-44;0;
Spain;ESP;47398695;cases;133386;2304;2020-45;587.8431885;86.62685755;1433277;42437;5342;4974;Spain2020-45;0;
Spain;ESP;47398695;cases;112150;2357;2020-46;518.0227008;98.33604069;1545427;44794;5110;4920;Spain2020-46;0;
Spain;ESP;47398695;cases;81314;2190;2020-47;408.1631361;95.93091118;1626741;46984;4936;4759;Spain2020-47;0;
Spain;ESP;47398695;cases;58665;1880;2020-48;295.3224767;85.86734297;1685406;48864;4991;4543;Spain2020-48;0;
Spain;ESP;47398695;cases;50733;1530;2020-49;230.8038228;71.94290898;1736139;50394;4865;4676;Spain2020-49;0;
Spain;ESP;47398695;cases;50710;1366;2020-50;214.0206603;61.09872856;1786849;51760;4901;4633;Spain2020-50;0;
Spain;ESP;47398695;cases;68437;1159;2020-51;251.3718996;53.27150885;1855286;52919;4737;4550;Spain2020-51;0;
Spain;ESP;47398695;cases;66223;1178;2020-52;284.1006488;49.30515492;1921509;54097;4728;4287;Spain2020-52;0;
Spain;ESP;47398695;cases;99024;1299;2020-53;348.6319613;52.25882274;2020533;55396;4933;4591;Spain2020-53;0;ALL
Spain;ESP;47398695;cases;160574;1572;2021-01;547.6901843;60.57128788;2181107;56968;5362;5117;Spain2021-01;0;ALL
Spain;ESP;47398695;cases;234159;2320;2021-02;832.7929704;82.11196532;2415266;59288;6113;5749;Spain2021-02;7268;ALL
Spain;ESP;47398695;cases;244762;3405;2021-03;1010.409675;120.7839161;2660028;62693;6630;6320;Spain2021-03;18449;ALL
Spain;ESP;47398695;cases;202249;3823;2021-04;943.0871462;152.4936499;2862277;66516;6614;6089;Spain2021-04;0;ALL
Spain;ESP;47398695;cases;130441;3320;2021-05;701.8969615;150.7003516;2992718;69836;6016;5561;Spain2021-05;53073;ALL
Spain;ESP;47398695;cases;75654;2469;2021-06;434.8115491;122.1341642;3068372;72305;5428;4947;Spain2021-06;42868;ALL
Spain;ESP;47398695;cases;50379;1692;2021-07;265.8997257;87.78722705;3118751;73997;4976;4513;Spain2021-07;285321;ALL
Spain;ESP;47398695;cases;38961;1318;2021-08;188.486202;63.50385807;3157712;75315;4792;4245;Spain2021-08;10316;ALL
Spain;ESP;47398695;cases;33651;940;2021-09;153.1940911;47.63844237;3191363;76255;4500;4046;Spain2021-09;296444;ALL
Spain;ESP;47398695;cases;32490;726;2021-10;139.5418165;35.14864702;3223853;76981;4436;3889;Spain2021-10;294522;ALL
Spain;ESP;47398695;cases;34076;598;2021-11;140.4384657;27.9332585;3257929;77579;4210;3870;Spain2021-11;0;ALL
Spain;ESP;47398695;cases;42852;536;2021-12;162.299827;23.92470932;3300781;78115;4332;3867;Spain2021-12;237545;ALL
Spain;ESP;47398695;cases;43334;547;2021-13;181.8320104;22.84873033;3344115;78662;4220;3980;Spain2021-13;434724;ALL
Spain;ESP;47398695;cases;60100;568;2021-14;218.2211979;23.5238544;3404215;79230;4133;3946;Spain2021-14;1013854;ALL
Spain;ESP;47398695;cases;58969;578;2021-15;251.2073381;24.17788085;3463184;79808;4048;3910;Spain2021-15;535711;ALL
Spain;ESP;47398695;cases;58041;527;2021-16;246.8633366;23.31287813;3521225;80335;4185;3909;Spain2021-16;84360;ALL
Spain;ESP;47398695;cases;52991;462;2021-17;234.2511751;20.86555337;3574216;80797;4062;3805;Spain2021-17;98209;ALL
Spain;ESP;47398695;cases;41923;460;2021-18;200.2460194;19.45201234;3616139;81257;4153;3914;Spain2021-18;165900;ALL
Spain;ESP;47398695;cases;34719;366;2021-19;161.6964349;17.42664012;3650858;81623;4018;3726;Spain2021-19;917975;ALL
Spain;ESP;47398695;cases;32367;263;2021-20;141.5355423;13.27040755;3683225;81886;3942;3673;Spain2021-20;287399;ALL
Spain;ESP;47398695;cases;30848;186;2021-21;133.3686508;9.472834642;3714073;82072;3841;3597;Spain2021-21;116697;ALL
Spain;ESP;47398695;cases;28306;211;2021-22;124.8009043;8.375758025;3742379;82283;3744;3611;Spain2021-22;114376;ALL
Spain;ESP;47398695;cases;24336;144;2021-23;111.0621295;7.489657679;3766715;82427;3878;3835;Spain2021-23;231677;ALL
Spain;ESP;47398695;cases;23617;129;2021-24;101.169452;5.759652244;3790332;82556;3893;3914;Spain2021-24;197294;ALL
Spain;ESP;47398695;cases;29792;115;2021-25;112.6803175;5.147821053;3820124;82671;3741;3545;Spain2021-25;82083;ALL
Spain;ESP;47398695;cases;78957;90;2021-26;229.4345868;4.32501359;3899081;82761;3916;3639;Spain2021-26;5720;ALL
Spain;ESP;47398695;cases;135307;90;2021-27;452.0462009;3.797572908;4034388;82851;3799;3744;Spain2021-27;5739;ALL
Spain;ESP;47398695;cases;176685;168;2021-28;658.2290926;5.443187835;4211073;83019;3836;3728;Spain2021-28;463328;ALL
Spain;ESP;47398695;cases;185943;385;2021-29;765.059038;11.66698788;4397016;83404;4348;4131;Spain2021-29;2728;ALL
Spain;ESP;47398695;cases;157845;559;2021-30;725.3111082;19.91616014;4554861;83963;4223;4144;Spain2021-30;2818;ALL
Spain;ESP;47398695;cases;119276;696;2021-31;584.6595566;26.47752222;4674137;84659;4417;4225;Spain2021-31;47128;ALL
Spain;ESP;47398695;cases;90757;802;2021-32;443.1197948;31.60424564;4764894;85461;4580;4276;Spain2021-32;87219;ALL
Spain;ESP;47398695;cases;68530;714;2021-33;336.0577754;31.98400294;4833424;86175;4403;4356;Spain2021-33;423;ALL
Spain;ESP;47398695;cases;51921;635;2021-34;254.1230302;28.46069918;4885345;86810;4145;4074;Spain2021-34;262;ALL
Spain;ESP;47398695;cases;34239;543;2021-35;181.7771565;24.85300492;4919584;87353;4077;3862;Spain2021-35;7832;ALL
Spain;ESP;47398695;cases;23196;418;2021-36;121.1742222;20.2748198;4942780;87771;3996;3904;Spain2021-36;182540;ALL
Spain;ESP;47398695;cases;17863;351;2021-37;86.62474779;16.22407537;4960643;88122;3857;3655;Spain2021-37;28418;ALL
Spain;ESP;47398695;cases;14470;231;2021-38;68.21495824;12.27881907;4975113;88353;3843;3592;Spain2021-38;4456;ALL
Spain;ESP;47398695;cases;12146;179;2021-39;56.15344473;8.650027179;4987259;88532;3892;3663;Spain2021-39;3412;ALL
Spain;ESP;47398695;cases;10340;146;2021-40;47.44012467;6.856728861;4997599;88678;3898;3631;Spain2021-40;53878;ALL
Spain;ESP;47398695;cases;10622;124;2021-41;44.22484627;5.696359362;5008221;88802;3913;3677;Spain2021-41;17;ALL
Spain;ESP;47398695;cases;12402;120;2021-42;48.57517702;5.147821053;5020623;88922;3842;3903;Spain2021-42;9;ALL
Spain;ESP;47398695;cases;13428;100;2021-43;54.49517123;4.641477998;5034051;89022;4107;4075;Spain2021-43;15;ALL
Spain;ESP;47398695;cases;16057;95;2021-44;62.20635399;4.114037317;5050108;89117;3972;3847;Spain2021-44;590;ALL
Spain;ESP;47398695;cases;25448;157;2021-45;87.56570197;5.316602071;5075556;89274;4320;4403;Spain2021-45;6759;ALL
Spain;ESP;47398695;cases;40654;148;2021-46;139.4595358;6.434776316;5116210;89422;4392;4394;Spain2021-46;44416;ALL
Spain;ESP;47398695;cases;59181;184;2021-47;210.6281618;7.004412252;5175391;89606;4505;4343;Spain2021-47;194;ALL
Spain;ESP;47398695;cases;89686;277;2021-48;314.0740478;9.72600617;5265077;89883;4673;4704;Spain2021-48;3;ALL
Spain;ESP;47398695;cases;115531;338;2021-49;432.9591775;12.97504077;5380608;90221;4700;4312;Spain2021-49;22456;ALL
Spain;ESP;47398695;cases;229802;473;2021-50;728.5706917;17.11017571;5610410;90694;4838;4651;Spain2021-50;28882;ALL
Spain;ESP;47398695;cases;490059;556;2021-51;1518.735906;21.70945846;6100469;91250;5006;4774;Spain2021-51;26602;ALL
Spain;ESP;47398695;cases;791186;690;2021-52;2703.122945;26.28764357;6891655;91940;4941;4886;Spain2021-52;30;ALL
Spain;ESP;47398695;cases;889023;915;2022-01;3544.842321;33.86169176;7780678;92855;5091;4845;Spain2022-01;11483;ALL
Spain;ESP;47398695;cases;954252;1276;2022-02;3888.87289;46.22490134;8734930;94131;5399;5296;Spain2022-02;0;ALL
Spain;ESP;47398695;cases;845658;1481;2022-03;3797.383029;58.16615837;9580588;95612;5579;5270;Spain2022-03;17;ALL
Spain;ESP;47398695;cases;624879;1670;2022-04;3102.484151;66.47862351;10205467;97282;5931;5297;Spain2022-04;11237;ALL
Spain;ESP;47398695;cases;382638;1644;2022-05;2125.621813;69.91753676;10588105;98926;5610;5281;Spain2022-05;9157;ALL
Spain;ESP;47398695;cases;243573;1370;2022-06;1321.156627;63.58824858;10831678;100296;5106;4925;Spain2022-06;7123;ALL
Spain;ESP;47398695;cases;157909;911;2022-07;847.031759;48.12368779;10989587;101207;4757;4512;Spain2022-07;5923;ALL
Spain;ESP;47398695;cases;117420;638;2022-08;580.8788617;32.68022463;11107007;101845;4532;4412;Spain2022-08;4767;ALL
Spain;ESP;47398695;cases;110513;520;2022-09;480.8845476;24.43105237;11217520;102365;4310;4319;Spain2022-09;30;ALL
Spain;ESP;47398695;cases;109401;433;2022-10;463.9663603;20.10603878;11326921;102798;4362;4145;Spain2022-10;3819;ALL
Spain;ESP;47398695;cases;116004;365;2022-11;475.5510674;16.83590656;11442925;103163;4341;4190;Spain2022-11;0;ALL
Spain;ESP;47398695;cases;119806;289;2022-12;497.5031486;13.79784823;11562731;103452;4356;4182;Spain2022-12;1164;ALL
Spain;ESP;47398695;cases;65812;278;2022-13;391.6099378;11.96235466;11628543;103730;4379;4117;Spain2022-13;4;ALL
Spain;ESP;47398695;cases;70620;305;2022-14;287.8391483;12.2999167;11699163;104035;4365;4337;Spain2022-14;1973;ALL
Spain;ESP;47398695;cases;72745;344;2022-15;302.4661333;13.6923601;11771908;104379;4468;4224;Spain2022-15;345;ALL
Spain;ESP;47398695;cases;100751;362;2022-16;366.035394;14.89492485;11872659;104741;4240;4138;Spain2022-16;0;ALL
Spain;ESP;47398695;cases;117213;371;2022-17;459.8523229;15.46456079;11989872;105112;4339;4162;Spain2022-17;560;ALL
Spain;ESP;47398695;cases;118020;423;2022-18;496.2858155;16.75151605;12107892;105535;4303;4159;Spain2022-18;0;ALL
Spain;ESP;47398695;cases;120362;486;2022-19;502.9294583;19.17774318;12228254;106021;4397;4382;Spain2022-19;0;ALL
Spain;ESP;47398695;cases;98000;420;2022-20;460.6920085;19.1144503;12326254;106441;4338;4491;Spain2022-20;737;ALL
Spain;ESP;47398695;cases;76763;311;2022-21;368.7084634;15.42236553;12403017;106752;3921;4014;Spain2022-21;0;ALL
Spain;ESP;47398695;cases;67909;194;2022-22;305.2235932;10.65430177;12470926;106946;:;:;Spain2022-22;0;
France;FRA;67656682;cases;0;0;2020-01;;0;0;0;6361;6618;France2020-01;0;
France;FRA;67656682;cases;0;0;2020-02;0;0;0;0;6663;6772;France2020-02;0;
France;FRA;67656682;cases;0;0;2020-03;0;0;0;0;6359;6476;France2020-03;0;
France;FRA;67656682;cases;3;0;2020-04;0.004434152;0;3;0;6178;6407;France2020-04;0;
France;FRA;67656682;cases;3;1;2020-05;0.008868304;0.014780506;6;1;6458;6328;France2020-05;0;
France;FRA;67656682;cases;6;0;2020-06;0.013302455;0.014780506;12;1;6304;6356;France2020-06;0;
France;FRA;67656682;cases;0;0;2020-07;0.008868304;0;12;1;6251;6258;France2020-07;0;
France;FRA;67656682;cases;4;0;2020-08;0.005912202;0;16;1;6073;6030;France2020-08;0;
France;FRA;67656682;cases;133;0;2020-09;0.202492933;0;149;1;6061;6219;France2020-09;0;
France;FRA;67656682;cases;981;0;2020-10;1.646548378;0;1130;1;6277;6133;France2020-10;0;
France;FRA;67656682;cases;4297;43;2020-11;7.801151112;0.635561762;5427;44;6389;6421;France2020-11;0;
France;FRA;67656682;cases;11266;670;2020-12;23.00290162;10.53850084;16693;714;7074;7131;France2020-12;0;
France;FRA;67656682;cases;23485;2002;2020-13;51.3637367;39.49351226;40178;2716;8492;7946;France2020-13;0;
France;FRA;67656682;cases;31002;3287;2020-14;80.53454351;78.17409668;71180;6003;9602;9450;France2020-14;0;
France;FRA;67656682;cases;25898;3348;2020-15;84.10107962;98.06865787;97078;9351;8757;9029;France2020-15;0;
France;FRA;67656682;cases;16220;2741;2020-16;62.25253553;89.99850155;113298;12092;7521;8137;France2020-16;0;
France;FRA;67656682;cases;11120;2101;2020-17;40.40990364;71.56721046;124418;14193;6514;6532;France2020-17;0;
France;FRA;67656682;cases;6144;1408;2020-18;25.51706571;51.86479585;130562;15601;5701;5833;France2020-18;0;
France;FRA;67656682;cases;4046;1062;2020-19;15.0613357;36.50785003;134608;16663;5624;5683;France2020-19;0;
France;FRA;67656682;cases;3392;815;2020-20;10.99374043;27.74300992;138000;17478;5542;5467;France2020-20;0;
France;FRA;67656682;cases;4668;566;2020-21;11.9130879;20.4118789;142668;18044;5815;5561;France2020-21;0;
France;FRA;67656682;cases;4012;474;2020-22;12.82947928;15.37172633;146680;18518;5412;5284;France2020-22;0;
France;FRA;67656682;cases;3170;335;2020-23;10.61535947;11.95742942;149850;18853;5352;5288;France2020-23;0;
France;FRA;67656682;cases;3284;263;2020-24;9.539338627;8.838742639;153134;19116;5362;5294;France2020-24;0;
France;FRA;67656682;cases;3559;164;2020-25;10.11430031;6.311276098;156693;19280;5380;5329;France2020-25;0;
France;FRA;67656682;cases;3575;123;2020-26;10.54441304;4.242005246;160268;19403;5744;5637;France2020-26;0;
France;FRA;67656682;cases;3834;105;2020-27;10.95087696;3.369955387;164102;19508;5230;5056;France2020-27;0;
France;FRA;67656682;cases;4005;133;2020-28;11.58643872;3.517760448;168107;19641;5262;5327;France2020-28;0;
France;FRA;67656682;cases;4513;105;2020-29;12.59003508;3.517760448;172620;19746;5279;5115;France2020-29;0;
France;FRA;67656682;cases;6639;113;2020-30;16.48322039;3.222150327;179259;19859;5472;5350;France2020-30;0;
France;FRA;67656682;cases;8517;90;2020-31;22.40133502;3.000442735;187776;19949;5621;5530;France2020-31;0;
France;FRA;67656682;cases;11935;79;2020-32;30.22909105;2.497905528;199711;20028;5675;5338;France2020-32;0;
France;FRA;67656682;cases;17353;119;2020-33;43.28914622;2.926540205;217064;20147;6039;6046;France2020-33;0;
France;FRA;67656682;cases;28177;138;2020-34;67.29564421;3.798590064;245241;20285;5360;5414;France2020-34;0;
France;FRA;67656682;cases;39986;131;2020-35;100.7483636;3.975956137;285227;20416;5466;5341;France2020-35;0;
France;FRA;67656682;cases;52854;154;2020-36;137.2222185;4.212444234;338081;20570;5467;5445;France2020-36;0;
France;FRA;67656682;cases;64706;301;2020-37;173.7596295;6.725130269;402787;20871;5791;5702;France2020-37;0;
France;FRA;67656682;cases;75853;515;2020-38;207.7533155;12.06089297;478640;21386;6064;6064;France2020-38;0;
France;FRA;67656682;cases;74124;677;2020-39;221.6735961;17.61836325;552764;22063;5636;5529;France2020-39;0;
France;FRA;67656682;cases;79973;663;2020-40;227.7631646;19.80587815;632737;22726;6053;6115;France2020-40;0;
France;FRA;67656682;cases;123089;793;2020-41;300.1359127;21.52041686;755826;23519;6228;5903;France2020-41;0;
France;FRA;67656682;cases;174828;1097;2020-42;440.3364031;27.9351565;930654;24616;6308;6145;France2020-42;0;
France;FRA;67656682;cases;275475;2037;2020-43;665.5706232;46.32210607;1206129;26653;7169;6794;France2020-43;0;
France;FRA;67656682;cases;334606;3517;2020-44;901.7305933;82.0909308;1540735;30170;7442;7440;France2020-44;0;
France;FRA;67656682;cases;304647;5281;2020-45;944.8482856;130.0388925;1845382;35451;7956;7930;France2020-45;0;
France;FRA;67656682;cases;178339;6018;2020-46;713.8777512;167.0049383;2023721;41469;7867;7873;France2020-46;0;
France;FRA;67656682;cases;116391;6208;2020-47;435.6258558;180.7064674;2140112;47677;7717;7554;France2020-47;0;
France;FRA;67656682;cases;78267;5215;2020-48;287.7143754;168.837721;2218379;52892;7531;7446;France2020-48;0;
France;FRA;67656682;cases;72129;4450;2020-49;222.2928993;142.8535913;2290508;57342;7420;7397;France2020-49;0;
France;FRA;67656682;cases;78745;4257;2020-50;222.9994075;128.6938665;2369253;61599;7309;7483;France2020-50;0;
France;FRA;67656682;cases;94319;3786;2020-51;255.7973505;118.8796104;2463572;65385;7053;7314;France2020-51;0;
France;FRA;67656682;cases;85104;3560;2020-52;265.1962743;108.5775977;2548676;68945;6971;7157;France2020-52;0;
France;FRA;67656682;cases;89728;3259;2020-53;258.410544;100.788271;2638404;72204;7288;7391;France2020-53;4324;ALL
France;FRA;67656682;cases;123771;3857;2021-01;315.5623269;105.1780813;2762175;76061;7325;7651;France2021-01;3;ALL
France;FRA;67656682;cases;120598;3825;2021-02;361.1897492;113.5438477;2882773;79886;7419;7521;France2021-02;0;ALL
France;FRA;67656682;cases;132695;3754;2021-03;374.3798728;112.0214556;3015468;83640;7588;7849;France2021-03;0;ALL
France;FRA;67656682;cases;134230;3535;2021-04;394.5286587;107.7351089;3149698;87175;7444;7593;France2021-04;516903;ALL
France;FRA;67656682;cases;131751;3431;2021-05;393.1333789;102.9610054;3281449;90606;7373;7344;France2021-05;3421;ALL
France;FRA;67656682;cases;114509;3280;2021-06;363.9847429;99.19197634;3395958;93886;7310;7134;France2021-06;34462;ALL
France;FRA;67656682;cases;120536;2825;2021-07;347.4084053;90.23498965;3516494;96711;7252;7171;France2021-07;0;ALL
France;FRA;67656682;cases;130618;2395;2021-08;371.2183225;77.15424176;3647112;99106;6883;6754;France2021-08;767;ALL
France;FRA;67656682;cases;127029;2202;2021-09;380.8153051;67.94598647;3774141;101308;6705;6539;France2021-09;38714;ALL
France;FRA;67656682;cases;144730;2015;2021-10;401.6735553;62.32939416;3918871;103323;6703;6408;France2021-10;970;ALL
France;FRA;67656682;cases;185686;1890;2021-11;488.3715699;57.71787626;4104557;105213;6750;6520;France2021-11;52586;ALL
France;FRA;67656682;cases;226159;1929;2021-12;608.7277529;56.44675274;4330716;107142;6694;6398;France2021-12;3002;ALL
France;FRA;67656682;cases;244901;2040;2021-13;696.2505196;58.66382865;4575617;109182;6868;6648;France2021-13;66291;ALL
France;FRA;67656682;cases;205883;2188;2021-14;666.2815655;62.49197973;4781500;111370;6788;6498;France2021-14;186274;ALL
France;FRA;67656682;cases;205276;2053;2021-15;607.7138101;62.68412631;4986776;113423;6838;6524;France2021-15;5179;ALL
France;FRA;67656682;cases;182848;2128;2021-16;573.6669144;61.79729594;5169624;115551;6977;6538;France2021-16;50023;ALL
France;FRA;67656682;cases;146406;2040;2021-17;486.6540751;61.60514936;5316030;117591;6718;6306;France2021-17;15174;ALL
France;FRA;67656682;cases;109742;1584;2021-18;378.5997073;53.56455405;5425772;119175;6484;6293;France2021-18;139908;ALL
France;FRA;67656682;cases;84111;1257;2021-19;286.5245446;41.99141779;5509883;120432;5992;5804;France2021-19;171344;ALL
France;FRA;67656682;cases;85437;994;2021-20;250.6005246;33.2709192;5595320;121426;5827;5689;France2021-20;218148;ALL
France;FRA;67656682;cases;63401;804;2021-21;219.9900965;26.57534994;5658721;122230;5691;5674;France2021-21;145223;ALL
France;FRA;67656682;cases;49066;604;2021-22;166.2319178;20.81095257;5707787;122834;5742;5398;France2021-22;160486;ALL
France;FRA;67656682;cases;29340;398;2021-23;115.888036;14.8100671;5737127;123232;5579;5422;France2021-23;101626;ALL
France;FRA;67656682;cases;17288;332;2021-24;68.91854377;10.78976944;5754415;123564;5742;5419;France2021-24;66096;ALL
France;FRA;67656682;cases;12858;254;2021-25;44.55731364;8.661376566;5767273;123818;5261;4894;France2021-25;48716;ALL
France;FRA;67656682;cases;15749;209;2021-26;42.28259376;6.843374317;5783022;124027;5292;5147;France2021-26;5578;ALL
France;FRA;67656682;cases;25738;165;2021-27;61.3198856;5.527909276;5808760;124192;5555;5272;France2021-27;882608;ALL
France;FRA;67656682;cases;51040;124;2021-28;113.4817696;4.271566259;5859800;124316;5419;5208;France2021-28;3567;ALL
France;FRA;67656682;cases;122790;147;2021-29;256.9295373;4.005517149;5982590;124463;5939;5890;France2021-29;1615502;ALL
France;FRA;67656682;cases;153108;298;2021-30;407.7912068;6.577325208;6135698;124761;5580;5441;France2021-30;265260;ALL
France;FRA;67656682;cases;158592;362;2021-31;460.7083747;9.755134016;6294290;125123;5590;5451;France2021-31;90527;ALL
France;FRA;67656682;cases;166422;484;2021-32;480.3871405;12.50430815;6460712;125607;6070;6074;France2021-32;20900;ALL
France;FRA;67656682;cases;149868;850;2021-33;467.492627;19.71719512;6610580;126457;5992;5936;France2021-33;6695;ALL
France;FRA;67656682;cases;125261;765;2021-34;406.6545859;23.87051733;6735841;127222;5867;5710;France2021-34;483464;ALL
France;FRA;67656682;cases;95498;708;2021-35;326.2929743;21.77168546;6831339;127930;6028;5967;France2021-35;12886;ALL
France;FRA;67656682;cases;70669;633;2021-36;245.6032355;19.82065866;6902008;128563;6209;6022;France2021-36;275161;ALL
France;FRA;67656682;cases;51163;507;2021-37;180.0738617;16.84977694;6953171;129070;5704;5622;France2021-37;2784;ALL
France;FRA;67656682;cases;39700;421;2021-38;134.3001124;13.71630965;6992871;129491;5721;5563;France2021-38;134551;ALL
France;FRA;67656682;cases;33506;345;2021-39;108.2021728;11.32186766;7026377;129836;5892;5759;France2021-39;5190;ALL
France;FRA;67656682;cases;29250;253;2021-40;92.75654399;8.838742639;7055627;130089;5872;5852;France2021-40;43564;ALL
France;FRA;67656682;cases;32843;209;2021-41;91.77659643;6.828593811;7088470;130298;6315;6075;France2021-41;5354;ALL
France;FRA;67656682;cases;36085;204;2021-42;101.8790723;6.104349013;7124555;130502;6066;6209;France2021-42;30367;ALL
France;FRA;67656682;cases;39946;211;2021-43;112.3776658;6.133910025;7164501;130713;6210;6346;France2021-43;9656;ALL
France;FRA;67656682;cases;49560;242;2021-44;132.2943978;6.695569257;7214061;130955;5895;6078;France2021-44;3003;ALL
France;FRA;67656682;cases;68055;256;2021-45;173.8409223;7.36069203;7282116;131211;6232;6174;France2021-45;0;ALL
France;FRA;67656682;cases;122268;334;2021-46;281.307026;8.72049859;7404384;131545;6354;6199;France2021-46;11550;ALL
France;FRA;67656682;cases;198036;477;2021-47;473.4255221;11.98699044;7602420;132022;6578;6550;France2021-47;10194;ALL
France;FRA;67656682;cases;292049;658;2021-48;724.3704325;16.77587441;7894469;132680;6928;6837;France2021-48;876;ALL
France;FRA;67656682;cases;341145;943;2021-49;935.892777;23.66359024;8235614;133623;7127;7150;France2021-49;598;ALL
France;FRA;67656682;cases;365223;1084;2021-50;1044.047652;29.96008583;8600837;134707;7022;7153;France2021-50;9752;ALL
France;FRA;67656682;cases;526052;1198;2021-51;1317.349556;33.72911489;9126889;135905;7453;7491;France2021-51;1161;ALL
France;FRA;67656682;cases;1151117;1375;2021-52;2478.940661;38.03024216;10278006;137280;7491;7531;France2021-52;9931;ALL
France;FRA;67656682;cases;1752836;1551;2022-01;4292.189499;43.24776081;12030842;138831;7512;7397;France2022-01;0;ALL
France;FRA;67656682;cases;2028035;1587;2022-02;5588.318682;46.3812281;14058877;140418;7365;7582;France2022-02;0;ALL
France;FRA;67656682;cases;2486551;1771;2022-03;6672.786584;49.63293943;16545428;142189;7433;7453;France2022-03;613;ALL
France;FRA;67656682;cases;2404210;2082;2022-04;7228.792272;56.94928995;18949638;144271;7922;7543;France2022-04;3786;ALL
France;FRA;67656682;cases;1772483;2130;2022-05;6173.36363;62.25549163;20722121;146401;7702;7808;France2022-05;47631;ALL
France;FRA;67656682;cases;1004471;2146;2022-06;4104.47855;63.20144402;21726592;148547;7420;7237;France2022-06;12809;ALL
France;FRA;67656682;cases;597768;1872;2022-07;2368.190329;59.38807345;22324360;150419;6929;7135;France2022-07;23926;ALL
France;FRA;67656682;cases;413598;1464;2022-08;1494.850132;49.3077683;22737958;151883;6568;6461;France2022-08;522;ALL
France;FRA;67656682;cases;363517;1163;2022-09;1148.615299;38.82838949;23101475;153046;6590;6519;France2022-09;100;ALL
France;FRA;67656682;cases;443492;871;2022-10;1192.800144;30.06354938;23544967;153917;6492;6364;France2022-10;165;ALL
France;FRA;67656682;cases;606139;839;2022-11;1551.407738;25.27466541;24151106;154756;6258;6412;France2022-11;139;ALL
France;FRA;67656682;cases;870396;766;2022-12;2182.393455;23.72271227;25021502;155522;6323;6352;France2022-12;149;ALL
France;FRA;67656682;cases;976409;842;2022-13;2729.671254;23.76705378;25997911;156364;6508;6556;France2022-13;418;ALL
France;FRA;67656682;cases;945487;834;2022-14;2840.659552;24.7721282;26943398;157198;6601;6721;France2022-14;17;ALL
France;FRA;67656682;cases;839741;902;2022-15;2638.657332;25.65895856;27783139;158100;6620;6804;France2022-15;98;ALL
France;FRA;67656682;cases;556868;932;2022-16;2064.258782;27.10744816;28340007;159032;6378;6499;France2022-16;269;ALL
France;FRA;67656682;cases;394610;900;2022-17;1406.332637;27.07788715;28734617;159932;6062;6202;France2022-17;172;ALL
France;FRA;67656682;cases;280491;778;2022-18;997.8334439;24.80168921;29015108;160710;6075;6069;France2022-18;541;ALL
France;FRA;67656682;cases;231421;630;2022-19;756.6318431;20.81095257;29246529;161340;5632;5825;France2022-19;573;ALL
France;FRA;67656682;cases;175968;487;2022-20;602.1415594;16.5098253;29422497;161827;5263;5272;France2022-20;363;ALL
France;FRA;67656682;cases;125080;321;2022-21;444.9641796;11.94264892;29547577;162148;:;:;France2022-21;177;ALL
France;FRA;67656682;cases;156673;331;2022-22;416.4451931;9.636889967;29704250;162479;:;:;France2022-22;0;
Croatia;HRV;4036355;cases;0;0;2020-01;;0;0;0;491;542;Croatia2020-01;0;
Croatia;HRV;4036355;cases;0;0;2020-02;0;0;0;0;509;547;Croatia2020-02;0;
Croatia;HRV;4036355;cases;0;0;2020-03;0;0;0;0;509;507;Croatia2020-03;0;
Croatia;HRV;4036355;cases;0;0;2020-04;0;0;0;0;539;595;Croatia2020-04;0;
Croatia;HRV;4036355;cases;0;0;2020-05;0;0;0;0;525;569;Croatia2020-05;0;
Croatia;HRV;4036355;cases;0;0;2020-06;0;0;0;0;494;565;Croatia2020-06;0;
Croatia;HRV;4036355;cases;0;0;2020-07;0;0;0;0;549;542;Croatia2020-07;0;
Croatia;HRV;4036355;cases;0;0;2020-08;0;0;0;0;528;517;Croatia2020-08;0;
Croatia;HRV;4036355;cases;0;0;2020-09;0;0;0;0;498;523;Croatia2020-09;0;
Croatia;HRV;4036355;cases;5;0;2020-10;0.123874139;0;5;0;468;588;Croatia2020-10;0;
Croatia;HRV;4036355;cases;37;0;2020-11;1.040542767;0;42;0;554;528;Croatia2020-11;0;
Croatia;HRV;4036355;cases;157;0;2020-12;4.80631659;0;199;0;562;532;Croatia2020-12;0;
Croatia;HRV;4036355;cases;451;5;2020-13;15.06309529;1.238741389;650;5;553;569;Croatia2020-13;0;
Croatia;HRV;4036355;cases;525;10;2020-14;24.18023192;3.716224168;1175;15;491;521;Croatia2020-14;0;
Croatia;HRV;4036355;cases;418;8;2020-15;23.3626626;4.459469001;1593;23;490;511;Croatia2020-15;0;
Croatia;HRV;4036355;cases;271;24;2020-16;17.06985634;7.927944891;1864;47;463;515;Croatia2020-16;0;
Croatia;HRV;4036355;cases;159;8;2020-17;10.65317595;7.927944891;2023;55;419;449;Croatia2020-17;0;
Croatia;HRV;4036355;cases;66;24;2020-18;5.574336251;7.927944891;2089;79;423;486;Croatia2020-18;0;
Croatia;HRV;4036355;cases;91;11;2020-19;3.889647962;8.671189724;2180;90;452;428;Croatia2020-19;0;
Croatia;HRV;4036355;cases;39;5;2020-20;3.220727612;3.963972445;2219;95;444;464;Croatia2020-20;0;
Croatia;HRV;4036355;cases;18;4;2020-21;1.412165184;2.229734501;2237;99;446;458;Croatia2020-21;0;
Croatia;HRV;4036355;cases;2;4;2020-22;0.495496556;1.981986223;2239;103;436;412;Croatia2020-22;0;
Croatia;HRV;4036355;cases;1;1;2020-23;0.074324483;1.238741389;2240;104;476;496;Croatia2020-23;0;
Croatia;HRV;4036355;cases;5;3;2020-24;0.148648967;0.990993111;2245;107;479;500;Croatia2020-24;0;
Croatia;HRV;4036355;cases;65;0;2020-25;1.734237945;0.743244834;2310;107;419;470;Croatia2020-25;0;
Croatia;HRV;4036355;cases;374;0;2020-26;10.8761494;0;2684;107;448;479;Croatia2020-26;0;
Croatia;HRV;4036355;cases;460;6;2020-27;20.66220637;1.486489667;3144;113;467;503;Croatia2020-27;0;
Croatia;HRV;4036355;cases;571;6;2020-28;25.54284745;2.972979334;3715;119;449;470;Croatia2020-28;0;
Croatia;HRV;4036355;cases;623;1;2020-29;29.58114437;1.734237945;4338;120;440;448;Croatia2020-29;0;
Croatia;HRV;4036355;cases;512;16;2020-30;28.11942953;4.211720723;4850;136;475;499;Croatia2020-30;0;
Croatia;HRV;4036355;cases;403;13;2020-31;22.66896742;7.184700057;5253;149;534;525;Croatia2020-31;0;
Croatia;HRV;4036355;cases;344;8;2020-32;18.50679635;5.202713835;5597;157;453;503;Croatia2020-32;0;
Croatia;HRV;4036355;cases;967;9;2020-33;32.47979922;4.211720723;6564;166;460;466;Croatia2020-33;0;
Croatia;HRV;4036355;cases;1604;5;2020-34;63.69608223;3.46847589;8168;171;449;472;Croatia2020-34;0;
Croatia;HRV;4036355;cases;1948;13;2020-35;88.00018829;4.459469001;10116;184;489;483;Croatia2020-35;0;
Croatia;HRV;4036355;cases;1841;14;2020-36;93.87182247;6.689203502;11957;198;457;474;Croatia2020-36;0;
Croatia;HRV;4036355;cases;1569;26;2020-37;84.48216274;9.909931114;13526;224;482;518;Croatia2020-37;0;
Croatia;HRV;4036355;cases;1389;24;2020-38;73.28394059;12.38741389;14915;248;458;517;Croatia2020-38;0;
Croatia;HRV;4036355;cases;1275;24;2020-39;66.00014122;11.89191734;16190;272;451;512;Croatia2020-39;0;
Croatia;HRV;4036355;cases;1462;26;2020-40;67.80870364;12.38741389;17652;298;564;501;Croatia2020-40;0;
Croatia;HRV;4036355;cases;2781;26;2020-41;105.1195943;12.88291045;20433;324;462;508;Croatia2020-41;0;
Croatia;HRV;4036355;cases;5140;39;2020-42;196.2414109;16.10363806;25573;363;543;553;Croatia2020-42;0;
Croatia;HRV;4036355;cases;10800;74;2020-43;394.9107549;27.9955554;36373;437;553;583;Croatia2020-43;0;
Croatia;HRV;4036355;cases;15115;125;2020-44;642.039662;49.30190729;51488;562;535;621;Croatia2020-44;0;
Croatia;HRV;4036355;cases;15752;232;2020-45;764.7246092;88.44613519;67240;794;644;643;Croatia2020-45;0;
Croatia;HRV;4036355;cases;16959;255;2020-46;810.4093916;120.6534113;84199;1049;672;689;Croatia2020-46;0;
Croatia;HRV;4036355;cases;19512;304;2020-47;903.5627441;138.4912873;103711;1353;770;719;Croatia2020-47;0;
Croatia;HRV;4036355;cases;22894;359;2020-48;1050.601347;164.2571082;126605;1712;742;742;Croatia2020-48;0;
Croatia;HRV;4036355;cases;23741;462;2020-49;1155.374094;203.4013361;150346;2174;901;812;Croatia2020-49;0;
Croatia;HRV;4036355;cases;25533;466;2020-50;1220.754864;229.9104018;175879;2640;881;880;Croatia2020-50;0;
Croatia;HRV;4036355;cases;19076;537;2020-51;1105.180293;248.4915227;194955;3177;919;866;Croatia2020-51;0;
Croatia;HRV;4036355;cases;9968;494;2020-52;719.5600982;255.4284745;204923;3671;863;818;Croatia2020-52;2084;ALL
Croatia;HRV;4036355;cases;8028;401;2020-53;445.8478008;221.7347087;212951;4072;785;740;Croatia2020-53;5;ALL
Croatia;HRV;4036355;cases;7035;296;2021-01;373.1832309;172.6805497;219986;4368;649;693;Croatia2021-01;16;ALL
Croatia;HRV;4036355;cases;4961;248;2021-02;297.1988341;134.7750631;224947;4616;695;663;Croatia2021-02;16806;ALL
Croatia;HRV;4036355;cases;3966;211;2021-03;221.1648876;113.7164595;228913;4827;652;655;Croatia2021-03;234;ALL
Croatia;HRV;4036355;cases;3506;200;2021-04;185.1175132;101.8245422;232419;5027;587;657;Croatia2021-04;214;ALL
Croatia;HRV;4036355;cases;2976;142;2021-05;160.5904337;84.72991102;235395;5169;590;614;Croatia2021-05;1982;ALL
Croatia;HRV;4036355;cases;2255;149;2021-06;129.5971241;72.09474885;237650;5318;557;604;Croatia2021-06;235;ALL
Croatia;HRV;4036355;cases;2288;111;2021-07;112.5520426;64.41455224;239938;5429;577;544;Croatia2021-07;16036;ALL
Croatia;HRV;4036355;cases;3028;97;2021-08;131.7029845;51.53164179;242966;5526;532;564;Croatia2021-08;41561;ALL
Croatia;HRV;4036355;cases;3541;64;2021-09;162.7458437;39.88747273;246507;5590;496;538;Croatia2021-09;189;ALL
Croatia;HRV;4036355;cases;4531;87;2021-10;199.9824099;37.40998995;251038;5677;554;526;Croatia2021-10;4188;ALL
Croatia;HRV;4036355;cases;6594;96;2021-11;275.6199591;45.33793484;257632;5773;497;524;Croatia2021-11;21195;ALL
Croatia;HRV;4036355;cases;9583;120;2021-12;400.7823891;53.51362801;267215;5893;569;573;Croatia2021-12;260;ALL
Croatia;HRV;4036355;cases;12804;165;2021-13;554.6340696;70.60825918;280019;6058;634;597;Croatia2021-13;14063;ALL
Croatia;HRV;4036355;cases;12490;250;2021-14;626.654494;102.8155353;292509;6308;658;625;Croatia2021-14;27933;ALL
Croatia;HRV;4036355;cases;15274;254;2021-15;687.8483186;124.865132;307783;6562;646;643;Croatia2021-15;27636;ALL
Croatia;HRV;4036355;cases;14836;292;2021-16;745.9700646;135.2705597;322619;6854;654;664;Croatia2021-16;58557;ALL
Croatia;HRV;4036355;cases;12547;328;2021-17;678.4091092;153.6039323;335166;7182;711;630;Croatia2021-17;723;ALL
Croatia;HRV;4036355;cases;9321;287;2021-18;541.775934;152.3651909;344487;7469;669;583;Croatia2021-18;148713;ALL
Croatia;HRV;4036355;cases;5896;239;2021-19;376.9985544;130.3155941;350383;7708;631;624;Croatia2021-19;15658;ALL
Croatia;HRV;4036355;cases;3596;195;2021-20;235.1626653;107.5227526;353979;7903;547;559;Croatia2021-20;318;ALL
Croatia;HRV;4036355;cases;2155;111;2021-21;142.4800346;75.81097302;356134;8014;536;511;Croatia2021-21;10955;ALL
Croatia;HRV;4036355;cases;1424;72;2021-22;88.66910864;45.33793484;357558;8086;526;617;Croatia2021-22;184;ALL
Croatia;HRV;4036355;cases;939;46;2021-23;58.54291805;29.23429679;358497;8132;533;528;Croatia2021-23;53080;ALL
Croatia;HRV;4036355;cases;669;42;2021-24;39.83792308;21.80184845;359166;8174;494;536;Croatia2021-24;26437;ALL
Croatia;HRV;4036355;cases;479;26;2021-25;28.4415023;16.84688289;359645;8200;550;566;Croatia2021-25;18499;ALL
Croatia;HRV;4036355;cases;585;18;2021-26;26.36041676;10.90092422;360230;8218;464;518;Croatia2021-26;3040;ALL
Croatia;HRV;4036355;cases;589;9;2021-27;29.08564782;6.689203502;360819;8227;508;494;Croatia2021-27;32709;ALL
Croatia;HRV;4036355;cases;769;11;2021-28;33.64421613;4.954965557;361588;8238;515;476;Croatia2021-28;2963;ALL
Croatia;HRV;4036355;cases;1026;7;2021-29;44.47081587;4.459469001;362614;8245;491;418;Croatia2021-29;1701;ALL
Croatia;HRV;4036355;cases;1137;18;2021-30;53.5879525;6.193706946;363751;8263;513;556;Croatia2021-30;7326;ALL
Croatia;HRV;4036355;cases;1287;9;2021-31;60.05418255;6.689203502;365038;8272;461;496;Croatia2021-31;3813;ALL
Croatia;HRV;4036355;cases;1977;11;2021-32;80.86503789;4.954965557;367015;8283;507;556;Croatia2021-32;985;ALL
Croatia;HRV;4036355;cases;2743;18;2021-33;116.9371871;7.184700057;369758;8301;481;515;Croatia2021-33;226;ALL
Croatia;HRV;4036355;cases;3426;24;2021-34;152.8359126;10.40542767;373184;8325;458;505;Croatia2021-34;5092;ALL
Croatia;HRV;4036355;cases;4647;45;2021-35;200.0071847;17.09463117;377831;8370;524;519;Croatia2021-35;13076;ALL
Croatia;HRV;4036355;cases;6077;70;2021-36;265.6852532;28.49105195;383908;8440;544;548;Croatia2021-36;4322;ALL
Croatia;HRV;4036355;cases;8069;60;2021-37;350.4647138;32.20727612;391977;8500;563;548;Croatia2021-37;13661;ALL
Croatia;HRV;4036355;cases;7907;95;2021-38;395.8026487;38.40098307;399884;8595;533;547;Croatia2021-38;13353;ALL
Croatia;HRV;4036355;cases;8808;83;2021-39;414.1112464;44.09919346;408692;8678;554;552;Croatia2021-39;6078;ALL
Croatia;HRV;4036355;cases;9159;94;2021-40;445.1293308;43.85144518;417851;8772;573;526;Croatia2021-40;5809;ALL
Croatia;HRV;4036355;cases;10056;124;2021-41;476.0483159;54.00912457;427907;8896;556;574;Croatia2021-41;10341;ALL
Croatia;HRV;4036355;cases;17411;142;2021-42;680.4901947;65.90104191;445318;9038;613;605;Croatia2021-42;900;ALL
Croatia;HRV;4036355;cases;25023;182;2021-43;1051.295042;80.27044202;470341;9220;629;696;Croatia2021-43;5707;ALL
Croatia;HRV;4036355;cases;30979;280;2021-44;1387.439906;114.4597044;501320;9500;726;678;Croatia2021-44;71;ALL
Croatia;HRV;4036355;cases;37425;381;2021-45;1694.69732;163.7616117;538745;9881;755;780;Croatia2021-45;72116;ALL
Croatia;HRV;4036355;cases;31628;422;2021-46;1710.776183;198.9418671;570373;10303;781;782;Croatia2021-46;49469;ALL
Croatia;HRV;4036355;cases;32936;456;2021-47;1599.561981;217.5229879;603309;10759;852;864;Croatia2021-47;4305;ALL
Croatia;HRV;4036355;cases;27721;459;2021-48;1502.766729;226.6896742;631030;11218;815;821;Croatia2021-48;5231;ALL
Croatia;HRV;4036355;cases;23165;401;2021-49;1260.691887;213.0635189;654195;11619;772;796;Croatia2021-49;3248;ALL
Croatia;HRV;4036355;cases;21161;362;2021-50;1098.169016;189.031936;675356;11981;749;787;Croatia2021-50;5;ALL
Croatia;HRV;4036355;cases;17890;344;2021-51;967.4817998;174.9102842;693246;12325;710;778;Croatia2021-51;3769;ALL
Croatia;HRV;4036355;cases;27698;284;2021-52;1129.434849;155.5859185;720944;12609;735;743;Croatia2021-52;3589;ALL
Croatia;HRV;4036355;cases;44654;269;2022-01;1792.50834;137.0047976;765598;12878;694;714;Croatia2022-01;4364;ALL
Croatia;HRV;4036355;cases;51830;240;2022-02;2390.374484;126.1038734;817428;13118;687;717;Croatia2022-02;3;ALL
Croatia;HRV;4036355;cases;59625;289;2022-03;2761.278431;131.058839;877053;13407;725;726;Croatia2022-03;1400;ALL
Croatia;HRV;4036355;cases;58662;370;2022-04;2930.540054;163.2661151;935715;13777;752;802;Croatia2022-04;1047;ALL
Croatia;HRV;4036355;cases;48058;360;2022-05;2643.969621;180.8562428;983773;14137;779;827;Croatia2022-05;0;ALL
Croatia;HRV;4036355;cases;34135;336;2022-06;2036.31742;172.4328014;1017908;14473;679;732;Croatia2022-06;119;ALL
Croatia;HRV;4036355;cases;23297;342;2022-07;1422.867909;167.9733324;1041205;14815;697;719;Croatia2022-07;0;ALL
Croatia;HRV;4036355;cases;13384;215;2022-08;908.7654579;137.9957908;1054589;15030;621;605;Croatia2022-08;0;ALL
Croatia;HRV;4036355;cases;9232;184;2022-09;560.3075052;98.85156286;1063821;15214;589;625;Croatia2022-09;1;ALL
Croatia;HRV;4036355;cases;9558;122;2022-10;465.5190141;75.81097302;1073379;15336;557;578;Croatia2022-10;1;ALL
Croatia;HRV;4036355;cases;10626;99;2022-11;500.055124;54.7523694;1084005;15435;566;604;Croatia2022-11;0;ALL
Croatia;HRV;4036355;cases;10047;85;2022-12;512.1700148;45.58568312;1094052;15520;526;557;Croatia2022-12;130;ALL
Croatia;HRV;4036355;cases;8671;81;2022-13;463.7352265;41.12621412;1102723;15601;535;552;Croatia2022-13;0;ALL
Croatia;HRV;4036355;cases;6336;84;2022-14;371.7958406;40.87846584;1109059;15685;536;531;Croatia2022-14;218;ALL
Croatia;HRV;4036355;cases;4451;50;2022-15;267.2460673;33.19826923;1113510;15735;491;578;Croatia2022-15;97;ALL
Croatia;HRV;4036355;cases;4218;47;2022-16;214.7729821;24.03158295;1117728;15782;495;515;Croatia2022-16;6;ALL
Croatia;HRV;4036355;cases;5247;53;2022-17;234.493745;24.77482778;1122975;15835;469;451;Croatia2022-17;110;ALL
Croatia;HRV;4036355;cases;4760;53;2022-18;247.9217016;26.26131745;1127735;15888;:;:;Croatia2022-18;28;ALL
Croatia;HRV;4036355;cases;3708;42;2022-19;209.7932417;23.53608639;1131443;15930;:;:;Croatia2022-19;106;ALL
Croatia;HRV;4036355;cases;2782;36;2022-20;160.7886323;19.32436567;1134225;15966;:;:;Croatia2022-20;80;ALL
Croatia;HRV;4036355;cases;2185;17;2022-21;123.0565696;13.13065873;1136410;15983;:;:;Croatia2022-21;84;ALL
Croatia;HRV;4036355;cases;1629;15;2022-22;94.49119317;7.927944891;1138039;15998;:;:;Croatia2022-22;0;ALL
Italy;ITA;59236213;cases;0;0;2020-01;;0;0;0;6585;6898;Italy2020-01;0;
Italy;ITA;59236213;cases;0;0;2020-02;0;0;0;0;6725;7249;Italy2020-02;0;
Italy;ITA;59236213;cases;0;0;2020-03;0;0;0;0;6758;7291;Italy2020-03;0;
Italy;ITA;59236213;cases;0;0;2020-04;0;0;0;0;6712;7277;Italy2020-04;0;
Italy;ITA;59236213;cases;2;0;2020-05;0.003376313;0;2;0;6667;7233;Italy2020-05;0;
Italy;ITA;59236213;cases;1;0;2020-06;0.00506447;0;3;0;6494;7043;Italy2020-06;0;
Italy;ITA;59236213;cases;0;0;2020-07;0.001688157;0;3;0;6549;7092;Italy2020-07;0;
Italy;ITA;59236213;cases;175;3;2020-08;0.295427393;0.050644696;178;3;6232;7025;Italy2020-08;0;
Italy;ITA;59236213;cases;1978;66;2020-09;3.634601017;1.164828008;2156;69;6533;7163;Italy2020-09;0;
Italy;ITA;59236213;cases;8239;603;2020-10;17.2478953;11.29376721;10395;672;7247;7459;Italy2020-10;0;
Italy;ITA;59236213;cases;21095;2270;2020-11;49.52038376;48.50073721;31490;2942;9213;9021;Italy2020-11;0;
Italy;ITA;59236213;cases;36642;4702;2020-12;97.46909378;117.6982735;68132;7644;11559;10370;Italy2020-12;0;
Italy;ITA;59236213;cases;36853;5986;2020-13;124.0710644;180.4301703;104985;13630;11995;11462;Italy2020-13;0;
Italy;ITA;59236213;cases;30958;4871;2020-14;114.4755827;183.2831548;135943;18501;10342;10559;Italy2020-14;0;
Italy;ITA;59236213;cases;28192;4198;2020-15;99.85445896;153.098916;164135;22699;9028;9921;Italy2020-15;0;
Italy;ITA;59236213;cases;20725;3456;2020-16;82.57955315;129.2115011;184860;26155;7718;9039;Italy2020-16;0;
Italy;ITA;59236213;cases;16924;2640;2020-17;63.55740533;102.9100223;201784;28795;6909;7816;Italy2020-17;0;
Italy;ITA;59236213;cases;11427;1981;2020-18;47.86092588;78.00971342;213211;30776;6234;6922;Italy2020-18;0;
Italy;ITA;59236213;cases;8271;1393;2020-19;33.2533074;56.95840144;221482;32169;6011;6593;Italy2020-19;0;
Italy;ITA;59236213;cases;5273;991;2020-20;22.86439209;40.24565176;226755;33160;5689;6287;Italy2020-20;0;
Italy;ITA;59236213;cases;3860;628;2020-21;15.41793362;27.33125428;230615;33788;5457;5990;Italy2020-21;0;
Italy;ITA;59236213;cases;2853;426;2020-22;11.33259481;17.79316986;233468;34214;5314;5668;Italy2020-22;0;
Italy;ITA;59236213;cases;1855;417;2020-23;7.94784096;14.23115958;235323;34631;5379;5765;Italy2020-23;0;
Italy;ITA;59236213;cases;2162;254;2020-24;6.781324795;11.32753034;237485;34885;5134;5574;Italy2020-24;0;
Italy;ITA;59236213;cases;1608;242;2020-25;6.364350132;8.373256407;239093;35127;5347;5776;Italy2020-25;0;
Italy;ITA;59236213;cases;1413;187;2020-26;5.099920888;7.242191529;240506;35314;5724;6346;Italy2020-26;0;
Italy;ITA;59236213;cases;1467;102;2020-27;4.861890817;4.878772382;241973;35416;5845;6551;Italy2020-27;0;
Italy;ITA;59236213;cases;1455;74;2020-28;4.932793391;2.971155499;243428;35490;5425;6059;Italy2020-28;0;
Italy;ITA;59236213;cases;1507;89;2020-29;5.000319652;2.75169515;244935;35579;5278;5645;Italy2020-29;0;
Italy;ITA;59236213;cases;1754;64;2020-30;5.505078456;2.582879496;246689;35643;5520;5873;Italy2020-30;0;
Italy;ITA;59236213;cases;2110;51;2020-31;6.523036846;1.941380014;248799;35694;6015;6709;Italy2020-31;0;
Italy;ITA;59236213;cases;2768;43;2020-32;8.234827571;1.586867142;251567;35737;5855;6260;Italy2020-32;0;
Italy;ITA;59236213;cases;3476;52;2020-33;10.5408494;1.603748707;255043;35789;5806;6604;Italy2020-33;0;
Italy;ITA;59236213;cases;7076;40;2020-34;17.81342774;1.553104011;262119;35829;5692;6222;Italy2020-34;0;
Italy;ITA;59236213;cases;9453;41;2020-35;27.90353934;1.367406792;271572;35870;5628;6133;Italy2020-35;0;
Italy;ITA;59236213;cases;9463;75;2020-36;31.93316899;1.958261579;281035;35945;5446;5816;Italy2020-36;0;
Italy;ITA;59236213;cases;9917;77;2020-37;32.71647362;2.565997931;290952;36022;5557;6070;Italy2020-37;0;
Italy;ITA;59236213;cases;10798;130;2020-38;34.97016259;3.494484024;301750;36152;5724;6097;Italy2020-38;0;
Italy;ITA;59236213;cases;12504;151;2020-39;39.33742355;4.743719859;314254;36303;5433;5746;Italy2020-39;0;
Italy;ITA;59236213;cases;18020;161;2020-40;51.52929003;5.267048385;332274;36464;5801;6216;Italy2020-40;0;
Italy;ITA;59236213;cases;37832;282;2020-41;94.28691871;7.478533444;370106;36746;5928;6318;Italy2020-41;0;
Italy;ITA;59236213;cases;75970;584;2020-42;192.1155898;14.61943558;446076;37330;6296;6450;Italy2020-42;0;
Italy;ITA;59236213;cases;142383;1150;2020-43;368.6140436;29.27263429;588459;38480;7127;7420;Italy2020-43;0;
Italy;ITA;59236213;cases;203574;2183;2020-44;584.0295699;56.26625726;792033;40663;7941;7718;Italy2020-44;0;
Italy;ITA;59236213;cases;244341;3505;2020-45;756.1506337;96.02234363;1036374;44168;8701;8634;Italy2020-45;0;
Italy;ITA;59236213;cases;243003;4785;2020-46;822.7129577;139.9481766;1279377;48953;9595;9052;Italy2020-46;0;
Italy;ITA;59236213;cases;214365;5407;2020-47;772.1087774;172.0569139;1493742;54360;9555;9229;Italy2020-47;0;
Italy;ITA;59236213;cases;162446;5326;2020-48;636.1159516;181.1898407;1656188;59686;9592;9295;Italy2020-48;0;
Italy;ITA;59236213;cases;130039;4731;2020-49;493.7604637;169.7779026;1786227;64417;8899;9096;Italy2020-49;0;
Italy;ITA;59236213;cases;108066;4384;2020-50;401.9585114;153.875468;1894293;68801;8581;8901;Italy2020-50;0;
Italy;ITA;59236213;cases;106922;3995;2020-51;362.9333968;141.4506359;2001215;72796;8267;8806;Italy2020-51;0;
Italy;ITA;59236213;cases;92469;3317;2020-52;336.6032194;123.4380057;2093684;76113;7619;8084;Italy2020-52;84;ALL
Italy;ITA;59236213;cases;117230;3244;2020-53;354.0047369;110.7599502;2210914;79357;7851;8487;Italy2020-53;2120;ALL
Italy;ITA;59236213;cases;122542;3315;2021-01;404.7726684;110.726187;2333456;82672;8272;8559;Italy2021-01;32174;ALL
Italy;ITA;59236213;cases;94236;3267;2021-02;365.955197;111.114463;2427692;85939;8347;8574;Italy2021-02;15348;ALL
Italy;ITA;59236213;cases;85187;3136;2021-03;302.8941097;108.0926628;2512879;89075;8319;8890;Italy2021-03;950;ALL
Italy;ITA;59236213;cases;82867;2831;2021-04;283.7014581;100.7323004;2595746;91906;7978;8405;Italy2021-04;4116;ALL
Italy;ITA;59236213;cases;83484;2571;2021-05;280.8265275;91.19421594;2679230;94477;7561;8096;Italy2021-05;64421;ALL
Italy;ITA;59236213;cases;83463;2122;2021-06;281.8326688;79.22518612;2762693;96599;7014;7310;Italy2021-06;20097;ALL
Italy;ITA;59236213;cases;89961;2077;2021-07;292.7668587;70.88569284;2852654;98676;7416;7549;Italy2021-07;5704;ALL
Italy;ITA;59236213;cases;121669;2058;2021-08;357.2645672;69.80527266;2974323;100734;7164;7279;Italy2021-08;2952;ALL
Italy;ITA;59236213;cases;142846;2254;2021-09;446.5427255;72.79330973;3117169;102988;7342;7409;Italy2021-09;18086;ALL
Italy;ITA;59236213;cases;156212;2479;2021-10;504.8567166;79.90044873;3273381;105467;7613;7646;Italy2021-10;72029;ALL
Italy;ITA;59236213;cases;149570;2854;2021-11;516.2078811;90.02938794;3422951;108321;7812;7747;Italy2021-11;897;ALL
Italy;ITA;59236213;cases;144624;2998;2021-12;496.6455232;98.79092034;3567575;111319;8064;7918;Italy2021-12;12011;ALL
Italy;ITA;59236213;cases;131737;3089;2021-13;466.5406278;102.7580882;3699312;114408;7972;7957;Italy2021-13;128137;ALL
Italy;ITA;59236213;cases;100937;2952;2021-14;392.7901333;101.9815362;3800249;117360;7721;7498;Italy2021-14;10773;ALL
Italy;ITA;59236213;cases;98020;2476;2021-15;335.8705594;91.63313664;3898269;119836;7400;7246;Italy2021-15;39602;ALL
Italy;ITA;59236213;cases;91474;2254;2021-16;319.8955342;79.84980404;3989743;122090;7349;7227;Italy2021-16;54783;ALL
Italy;ITA;59236213;cases;78127;1813;2021-17;286.3130363;68.65732622;4067870;123903;6924;6837;Italy2021-17;5128;ALL
Italy;ITA;59236213;cases;63846;1465;2021-18;239.6726475;55.33777117;4131716;125368;6379;6434;Italy2021-18;21933;ALL
Italy;ITA;59236213;cases;44475;1142;2021-19;182.8628039;44.01024083;4176191;126510;6105;6323;Italy2021-19;3999;ALL
Italy;ITA;59236213;cases;30527;818;2021-20;126.6151163;33.08786806;4206718;127328;6113;6075;Italy2021-20;285;ALL
Italy;ITA;59236213;cases;22472;588;2021-21;89.47060812;23.73548086;4229190;127916;5919;6086;Italy2021-21;74749;ALL
Italy;ITA;59236213;cases;16240;415;2021-22;65.35191573;16.93221003;4245430;128331;5781;6176;Italy2021-22;4698;ALL
Italy;ITA;59236213;cases;11608;286;2021-23;47.01178315;11.8339773;4257038;128617;5770;6104;Italy2021-23;52336;ALL
Italy;ITA;59236213;cases;7438;210;2021-24;32.15262934;8.373256407;4264476;128827;5721;5995;Italy2021-24;162464;ALL
Italy;ITA;59236213;cases;5294;139;2021-25;21.49360899;5.891666302;4269770;128966;6102;6769;Italy2021-25;16095;ALL
Italy;ITA;59236213;cases;5671;106;2021-26;18.51063639;4.135983507;4275441;129072;5890;6529;Italy2021-26;332;ALL
Italy;ITA;59236213;cases;8857;79;2021-27;24.52553812;3.123089587;4284298;129151;5846;6193;Italy2021-27;79;ALL
Italy;ITA;59236213;cases;18919;68;2021-28;46.89023588;2.481590104;4303217;129219;5649;6044;Italy2021-28;1;ALL
Italy;ITA;59236213;cases;31382;73;2021-29;84.9159618;2.380300712;4334599;129292;5633;6366;Italy2021-29;46853;ALL
Italy;ITA;59236213;cases;38495;92;2021-30;117.9633141;2.78545828;4373094;129384;6106;6744;Italy2021-30;70;ALL
Italy;ITA;59236213;cases;42672;145;2021-31;137.0226014;4.000930985;4415766;129529;6023;6623;Italy2021-31;6;ALL
Italy;ITA;59236213;cases;43332;236;2021-32;145.1882145;6.431876393;4459098;129765;6367;7385;Italy2021-32;211;ALL
Italy;ITA;59236213;cases;45562;313;2021-33;150.0669869;9.267979369;4504660;130078;6109;6780;Italy2021-33;904;ALL
Italy;ITA;59236213;cases;46215;372;2021-34;154.9339422;11.56387225;4550875;130450;5825;6250;Italy2021-34;4564;ALL
Italy;ITA;59236213;cases;40104;407;2021-35;145.7199838;13.1507394;4590979;130857;5841;6180;Italy2021-35;3848;ALL
Italy;ITA;59236213;cases;33096;397;2021-36;123.5730583;13.57277853;4624075;131254;5881;6261;Italy2021-36;526;ALL
Italy;ITA;59236213;cases;28949;381;2021-37;104.7416721;13.13385783;4653024;131635;5922;6309;Italy2021-37;161;ALL
Italy;ITA;59236213;cases;23727;343;2021-38;88.92533356;12.2222533;4676751;131978;5755;5878;Italy2021-38;5329;ALL
Italy;ITA;59236213;cases;20966;288;2021-39;75.44877995;10.65226773;4697717;132266;5566;5968;Italy2021-39;4010;ALL
Italy;ITA;59236213;cases;18093;239;2021-40;65.93770604;8.896584932;4715810;132505;5558;5820;Italy2021-40;442;ALL
Italy;ITA;59236213;cases;17985;222;2021-41;60.90531142;7.78240162;4733795;132727;6017;6498;Italy2021-41;236;ALL
Italy;ITA;59236213;cases;25537;233;2021-42;73.47194865;7.681112228;4759332;132960;6330;6742;Italy2021-42;31;ALL
Italy;ITA;59236213;cases;32308;278;2021-43;97.65141468;8.626479887;4791640;133238;6114;6589;Italy2021-43;27;ALL
Italy;ITA;59236213;cases;39082;305;2021-44;120.5174949;9.841952591;4830722;133543;6125;6618;Italy2021-44;81306;ALL
Italy;ITA;59236213;cases;54106;379;2021-45;157.3159311;11.54699069;4884828;133922;6046;6748;Italy2021-45;2253;ALL
Italy;ITA;59236213;cases;69424;444;2021-46;208.5379766;13.89352827;4954252;134366;6154;6627;Italy2021-46;178472;ALL
Italy;ITA;59236213;cases;86694;519;2021-47;263.5516217;16.25694742;5040946;134885;6102;6649;Italy2021-47;16767;ALL
Italy;ITA;59236213;cases;105066;576;2021-48;323.7208969;18.48531404;5146012;135461;6759;7120;Italy2021-48;2443;ALL
Italy;ITA;59236213;cases;123928;743;2021-49;386.5777172;22.26678468;5269940;136204;6847;7390;Italy2021-49;2254;ALL
Italy;ITA;59236213;cases;173943;870;2021-50;502.8528748;27.22996489;5443883;137074;7219;7753;Italy2021-50;2264;ALL
Italy;ITA;59236213;cases;297028;1075;2021-51;795.0727708;32.83464458;5740911;138149;7258;7956;Italy2021-51;2811;ALL
Italy;ITA;59236213;cases;825069;1169;2021-52;1894.275382;37.88223261;6565980;139318;7034;7903;Italy2021-52;787;ALL
Italy;ITA;59236213;cases;1220551;1670;2022-01;3453.326768;47.92676399;7786531;140988;7592;8040;Italy2022-01;96821;ALL
Italy;ITA;59236213;cases;1214550;2232;2022-02;4110.831663;65.87186794;9001081;143220;8027;8592;Italy2022-02;666;ALL
Italy;ITA;59236213;cases;1161685;2591;2022-03;4011.456641;81.41978961;10162766;145811;8087;8631;Italy2022-03;18;ALL
Italy;ITA;59236213;cases;925760;2700;2022-04;3523.933915;89.32036219;11088526;148511;8365;8704;Italy2022-04;10388;ALL
Italy;ITA;59236213;cases;664937;2560;2022-05;2685.345533;88.79703367;11753463;151071;7947;8604;Italy2022-05;6734;ALL
Italy;ITA;59236213;cases;462539;2102;2022-06;1903.355976;78.7018576;12216002;153173;7385;7898;Italy2022-06;305;ALL
Italy;ITA;59236213;cases;357562;1844;2022-07;1384.458861;66.61465681;12573564;155017;6961;7408;Italy2022-07;1189;ALL
Italy;ITA;59236213;cases;286073;1472;2022-08;1086.55663;55.97927065;12859637;156489;6562;7028;Italy2022-08;1117;ALL
Italy;ITA;59236213;cases;274410;1223;2022-09;946.1830384;45.49581858;13134047;157712;6516;7089;Italy2022-09;188;ALL
Italy;ITA;59236213;cases;366476;957;2022-10;1081.915888;36.80181243;13500523;158669;6571;7155;Italy2022-10;120;ALL
Italy;ITA;59236213;cases;503387;921;2022-11;1468.464907;31.7035797;14003910;159590;6392;7263;Italy2022-11;6;ALL
Italy;ITA;59236213;cases;505473;944;2022-12;1703.1136;31.48411935;14509383;160534;6241;7003;Italy2022-12;7;ALL
Italy;ITA;59236213;cases;493891;1038;2022-13;1687.082866;33.4592625;15003274;161572;:;:;Italy2022-13;108;ALL
Italy;ITA;59236213;cases;448859;997;2022-14;1591.509572;34.35398546;15452133;162569;:;:;Italy2022-14;7;ALL
Italy;ITA;59236213;cases;413713;1012;2022-15;1456.156557;33.91506476;15865846;163581;:;:;Italy2022-15;11;ALL
Italy;ITA;59236213;cases;435499;957;2022-16;1433.602786;33.23980215;16301345;164538;:;:;Italy2022-16;36;ALL
Italy;ITA;59236213;cases;358996;914;2022-17;1341.231925;31.58540874;16660341;165452;:;:;Italy2022-17;17;ALL
Italy;ITA;59236213;cases;294521;829;2022-18;1103.238993;29.42456838;16954862;166281;:;:;Italy2022-18;10;ALL
Italy;ITA;59236213;cases;256059;718;2022-19;929.4652243;26.11578157;17210921;166999;:;:;Italy2022-19;23;ALL
Italy;ITA;59236213;cases;186119;600;2022-20;746.4656797;22.24990311;17397040;167599;:;:;Italy2022-20;0;
Italy;ITA;59236213;cases;136646;453;2022-21;544.8778436;17.7762883;17533686;168052;:;:;Italy2022-21;0;
Italy;ITA;59236213;cases;84982;192;2022-22;374.1427562;10.88860964;17618668;168244;:;:;Italy2022-22;0;
Portugal;PRT;10298252;cases;0;0;2020-01;;0;0;0;1220;1278;Portugal2020-01;0;
Portugal;PRT;10298252;cases;0;0;2020-02;0;0;0;0;1330;1326;Portugal2020-02;0;
Portugal;PRT;10298252;cases;0;0;2020-03;0;0;0;0;1348;1415;Portugal2020-03;0;
Portugal;PRT;10298252;cases;0;0;2020-04;0;0;0;0;1304;1358;Portugal2020-04;0;
Portugal;PRT;10298252;cases;0;0;2020-05;0;0;0;0;1389;1293;Portugal2020-05;0;
Portugal;PRT;10298252;cases;0;0;2020-06;0;0;0;0;1240;1238;Portugal2020-06;0;
Portugal;PRT;10298252;cases;0;0;2020-07;0;0;0;0;1140;1138;Portugal2020-07;0;
Portugal;PRT;10298252;cases;1;0;2020-08;0.009710386;0;1;0;1169;1188;Portugal2020-08;0;
Portugal;PRT;10298252;cases;1;0;2020-09;0.019420772;0;2;0;1151;1151;Portugal2020-09;0;
Portugal;PRT;10298252;cases;27;0;2020-10;0.271890802;0;29;0;1082;1095;Portugal2020-10;0;
Portugal;PRT;10298252;cases;289;0;2020-11;3.068481913;0;318;0;1211;1137;Portugal2020-11;0;
Portugal;PRT;10298252;cases;1407;26;2020-12;16.46881432;2.524700308;1725;26;1218;1213;Portugal2020-12;0;
Portugal;PRT;10298252;cases;3722;124;2020-13;49.80456878;14.5655787;5447;150;1252;1289;Portugal2020-13;0;
Portugal;PRT;10298252;cases;5053;206;2020-14;85.20863541;32.04427314;10500;356;1292;1358;Portugal2020-14;0;
Portugal;PRT;10298252;cases;4444;246;2020-15;92.21953396;43.89094382;14944;602;1302;1302;Portugal2020-15;0;
Portugal;PRT;10298252;cases;4246;217;2020-16;84.38325261;44.95908626;19190;819;1153;1233;Portugal2020-16;0;
Portugal;PRT;10298252;cases;3194;187;2020-17;72.24527036;39.22995864;22384;1006;1095;1214;Portugal2020-17;0;
Portugal;PRT;10298252;cases;2373;140;2020-18;54.05771776;31.75296157;24757;1146;1069;1101;Portugal2020-18;0;
Portugal;PRT;10298252;cases;2330;80;2020-19;45.66794442;21.36284876;27087;1226;1063;1105;Portugal2020-19;0;
Portugal;PRT;10298252;cases;1850;69;2020-20;40.58941265;14.46847484;28937;1295;1018;1035;Portugal2020-20;0;
Portugal;PRT;10298252;cases;2005;68;2020-21;37.43353726;13.30322855;30942;1363;1077;990;Portugal2020-21;0;
Portugal;PRT;10298252;cases;1967;69;2020-22;38.5696524;13.30322855;32909;1432;1135;1195;Portugal2020-22;0;
Portugal;PRT;10298252;cases;2149;50;2020-23;39.96794796;11.5553591;35058;1482;988;1029;Portugal2020-23;0;
Portugal;PRT;10298252;cases;1985;31;2020-24;40.1427349;7.865412499;37043;1513;918;950;Portugal2020-24;0;
Portugal;PRT;10298252;cases;2457;20;2020-25;43.13353373;4.952296759;39500;1533;991;944;Portugal2020-25;0;
Portugal;PRT;10298252;cases;2694;38;2020-26;50.01819726;5.632023765;42194;1571;1068;1050;Portugal2020-26;0;
Portugal;PRT;10298252;cases;2459;54;2020-27;50.03761803;8.933554937;44653;1625;1032;1026;Portugal2020-27;0;
Portugal;PRT;10298252;cases;2559;41;2020-28;48.72671595;9.224866511;47212;1666;1040;1190;Portugal2020-28;0;
Portugal;PRT;10298252;cases;2120;29;2020-29;45.43489516;6.797270061;49332;1695;1231;1416;Portugal2020-29;0;
Portugal;PRT;10298252;cases;1707;29;2020-30;37.16164646;5.632023765;51039;1724;1182;1252;Portugal2020-30;0;
Portugal;PRT;10298252;cases;1447;18;2020-31;30.62655682;4.563881327;52486;1742;1025;1188;Portugal2020-31;0;
Portugal;PRT;10298252;cases;1486;22;2020-32;28.48056156;3.884154321;53972;1764;1015;1062;Portugal2020-32;0;
Portugal;PRT;10298252;cases;1608;19;2020-33;30.04393367;3.981258179;55580;1783;974;963;Portugal2020-33;0;
Portugal;PRT;10298252;cases;1536;23;2020-34;30.52945296;4.078362037;57116;1806;974;1030;Portugal2020-34;0;
Portugal;PRT;10298252;cases;2322;21;2020-35;37.46266842;4.272569753;59438;1827;1013;1058;Portugal2020-35;0;
Portugal;PRT;10298252;cases;2562;22;2020-36;47.42552425;4.175465895;62000;1849;1043;1011;Portugal2020-36;0;
Portugal;PRT;10298252;cases;3845;28;2020-37;62.21444183;4.855192901;65845;1877;1127;1100;Portugal2020-37;0;
Portugal;PRT;10298252;cases;4541;49;2020-38;81.43129533;7.476997067;70386;1926;1040;1081;Portugal2020-38;0;
Portugal;PRT;10298252;cases;4801;37;2020-39;90.71442416;8.350931789;75187;1963;947;942;Portugal2020-39;0;
Portugal;PRT;10298252;cases;5411;61;2020-40;99.1624598;9.516178085;80598;2024;1095;1041;Portugal2020-40;0;
Portugal;PRT;10298252;cases;7529;81;2020-41;125.6523923;13.78874784;88127;2105;1075;1075;Portugal2020-41;0;
Portugal;PRT;10298252;cases;12977;105;2020-42;199.1211712;18.06131759;101104;2210;1124;1076;Portugal2020-42;0;
Portugal;PRT;10298252;cases;17516;146;2020-43;296.0987942;24.37306836;118620;2356;1138;1082;Portugal2020-43;0;
Portugal;PRT;10298252;cases;23341;245;2020-44;396.7372327;37.96760848;141961;2601;1268;1199;Portugal2020-44;0;
Portugal;PRT;10298252;cases;32271;377;2020-45;540.0139752;60.39859968;174232;2978;1295;1259;Portugal2020-45;0;
Portugal;PRT;10298252;cases;34704;527;2020-46;650.353089;87.78188764;208936;3505;1363;1368;Portugal2020-46;0;
Portugal;PRT;10298252;cases;37009;480;2020-47;696.360897;97.78358502;245945;3985;1385;1318;Portugal2020-47;0;
Portugal;PRT;10298252;cases;33455;532;2020-48;684.2326251;98.26910431;279400;4517;1351;1342;Portugal2020-48;0;
Portugal;PRT;10298252;cases;26536;534;2020-49;582.5357546;103.5127126;305936;5051;1496;1347;Portugal2020-49;0;
Portugal;PRT;10298252;cases;26146;609;2020-50;511.5625448;110.9897097;332082;5660;1541;1476;Portugal2020-50;0;
Portugal;PRT;10298252;cases;26235;543;2020-51;508.6397187;111.8636444;358317;6203;1444;1473;Portugal2020-51;0;
Portugal;PRT;10298252;cases;20209;490;2020-52;450.9891582;100.3082853;378526;6693;1379;1413;Portugal2020-52;1;ALL
Portugal;PRT;10298252;cases;32799;530;2020-53;514.7281306;99.04593517;411325;7223;1558;1597;Portugal2020-53;1066;ALL
Portugal;PRT;10298252;cases;53679;745;2021-01;839.7347433;123.807419;465004;7968;1975;1855;Portugal2021-01;72;ALL
Portugal;PRT;10298252;cases;63312;1109;2021-02;1136.027745;180.0305528;528316;9077;2326;2288;Portugal2021-02;776;ALL
Portugal;PRT;10298252;cases;82170;1698;2021-03;1412.686347;272.5705294;610486;10775;2533;2506;Portugal2021-03;1;ALL
Portugal;PRT;10298252;cases;79404;2014;2021-04;1568.945875;360.4495209;689890;12789;2432;2379;Portugal2021-04;117;ALL
Portugal;PRT;10298252;cases;44663;1587;2021-05;1204.738435;349.6709927;734553;14376;1970;1997;Portugal2021-05;39;ALL
Portugal;PRT;10298252;cases;22966;1034;2021-06;656.7036814;254.5092119;757519;15410;1656;1733;Portugal2021-06;7;ALL
Portugal;PRT;10298252;cases;13895;608;2021-07;357.934531;159.4445349;771414;16018;1424;1436;Portugal2021-07;0;ALL
Portugal;PRT;10298252;cases;8838;326;2021-08;220.7462004;90.69500339;780252;16344;1268;1263;Portugal2021-08;39648;ALL
Portugal;PRT;10298252;cases;8810;209;2021-09;171.3688886;51.95056404;789062;16553;1204;1146;Portugal2021-09;1;ALL
Portugal;PRT;10298252;cases;7513;130;2021-10;158.5026274;32.91820787;796575;16683;1075;1062;Portugal2021-10;2654;ALL
Portugal;PRT;10298252;cases;4656;88;2021-11;118.1656848;21.16864105;801231;16771;1066;1041;Portugal2021-11;378;ALL
Portugal;PRT;10298252;cases;4869;59;2021-12;92.49142476;14.27426713;806100;16830;1037;1017;Portugal2021-12;7764;ALL
Portugal;PRT;10298252;cases;4300;42;2021-13;89.03452741;9.807489659;810400;16872;1080;1048;Portugal2021-13;1872;ALL
Portugal;PRT;10298252;cases;4570;34;2021-14;86.13112206;7.379893209;814970;16906;1014;980;Portugal2021-14;14;ALL
Portugal;PRT;10298252;cases;4238;27;2021-15;85.52907814;5.923335339;819208;16933;993;971;Portugal2021-15;17;ALL
Portugal;PRT;10298252;cases;4113;19;2021-16;81.09143183;4.466777469;823321;16952;994;919;Portugal2021-16;5499;ALL
Portugal;PRT;10298252;cases;3788;13;2021-17;76.72175822;3.107323456;827109;16965;945;947;Portugal2021-17;12;ALL
Portugal;PRT;10298252;cases;3497;15;2021-18;70.74016056;2.718908024;830606;16980;1025;1016;Portugal2021-18;8007;ALL
Portugal;PRT;10298252;cases;3283;17;2021-19;65.83641573;3.107323456;833889;16997;948;958;Portugal2021-19;0;ALL
Portugal;PRT;10298252;cases;3707;7;2021-20;67.87559675;2.330492592;837596;17004;912;924;Portugal2021-20;2379;ALL
Portugal;PRT;10298252;cases;3957;7;2021-21;74.42039678;1.359454012;841553;17011;1055;934;Portugal2021-21;12201;ALL
Portugal;PRT;10298252;cases;4341;12;2021-22;80.57678138;1.844973302;845894;17023;973;905;Portugal2021-22;57074;ALL
Portugal;PRT;10298252;cases;5167;10;2021-23;92.3263482;2.136284876;851061;17033;1012;930;Portugal2021-23;25;ALL
Portugal;PRT;10298252;cases;7888;22;2021-24;126.7690866;3.107323456;858949;17055;993;989;Portugal2021-24;49;ALL
Portugal;PRT;10298252;cases;9728;19;2021-25;171.0581563;3.981258179;868677;17074;934;915;Portugal2021-25;2966;ALL
Portugal;PRT;10298252;cases;14712;31;2021-26;237.321829;4.855192901;883389;17105;1009;937;Portugal2021-26;18;ALL
Portugal;PRT;10298252;cases;19576;49;2021-27;332.9497084;7.768308641;902965;17154;1006;940;Portugal2021-27;1;ALL
Portugal;PRT;10298252;cases;25840;52;2021-28;441.0068816;9.807489659;928805;17206;1006;1045;Portugal2021-28;10355;ALL
Portugal;PRT;10298252;cases;23159;86;2021-29;475.7991939;13.40033241;951964;17292;977;975;Portugal2021-29;1705;ALL
Portugal;PRT;10298252;cases;18755;79;2021-30;407.0011105;16.02213657;970719;17371;1001;974;Portugal2021-30;39408;ALL
Portugal;PRT;10298252;cases;16086;103;2021-31;338.3195517;17.67290216;986805;17474;1041;1014;Portugal2021-31;28241;ALL
Portugal;PRT;10298252;cases;16602;89;2021-32;317.4130911;18.64394074;1003407;17563;1014;1068;Portugal2021-32;0;ALL
Portugal;PRT;10298252;cases;16384;70;2021-33;320.306786;15.43951342;1019791;17633;1057;1062;Portugal2021-33;10;ALL
Portugal;PRT;10298252;cases;16217;83;2021-34;316.5682875;14.85689028;1036008;17716;1030;1050;Portugal2021-34;3220;ALL
Portugal;PRT;10298252;cases;12598;80;2021-35;279.8047669;15.82792886;1048606;17796;1038;1032;Portugal2021-35;35;ALL
Portugal;PRT;10298252;cases;9044;56;2021-36;210.1521695;13.20612469;1057650;17852;975;1013;Portugal2021-36;14530;ALL
Portugal;PRT;10298252;cases;6917;48;2021-37;154.9874678;10.09880123;1064567;17900;931;982;Portugal2021-37;5;ALL
Portugal;PRT;10298252;cases;6198;40;2021-38;127.3517098;8.545139505;1070765;17940;995;1031;Portugal2021-38;0;ALL
Portugal;PRT;10298252;cases;4751;45;2021-39;106.3190141;8.253827931;1075516;17985;1003;996;Portugal2021-39;9;ALL
Portugal;PRT;10298252;cases;4539;49;2021-40;90.20948409;9.127762653;1080055;18034;1058;1063;Portugal2021-40;11;ALL
Portugal;PRT;10298252;cases;4976;51;2021-41;92.3943209;9.710385801;1085031;18085;1082;1049;Portugal2021-41;738;ALL
Portugal;PRT;10298252;cases;5458;38;2021-42;101.3181655;8.642243363;1090489;18123;1020;1018;Portugal2021-42;70;ALL
Portugal;PRT;10298252;cases;5877;25;2021-43;110.0672231;6.117543055;1096366;18148;1076;1098;Portugal2021-43;8;ALL
Portugal;PRT;10298252;cases;6940;45;2021-44;124.4580148;6.797270061;1103306;18193;1090;1040;Portugal2021-44;2;ALL
Portugal;PRT;10298252;cases;9937;60;2021-45;163.8821812;10.19590509;1113243;18253;1173;1243;Portugal2021-45;76;ALL
Portugal;PRT;10298252;cases;14932;79;2021-46;241.4875845;13.49743626;1128175;18332;1225;1237;Portugal2021-46;15776;ALL
Portugal;PRT;10298252;cases;20267;92;2021-47;341.7958698;16.60475972;1148442;18424;1270;1282;Portugal2021-47;7;ALL
Portugal;PRT;10298252;cases;23872;122;2021-48;428.6067189;20.78022561;1172314;18546;1352;1373;Portugal2021-48;8667;ALL
Portugal;PRT;10298252;cases;27420;122;2021-49;498.0651085;23.69334136;1199734;18668;1315;1300;Portugal2021-49;7639;ALL
Portugal;PRT;10298252;cases;31766;125;2021-50;574.718894;23.98465293;1231500;18793;1245;1246;Portugal2021-50;18524;ALL
Portugal;PRT;10298252;cases;56667;93;2021-51;858.7185476;21.16864105;1288167;18886;1311;1275;Portugal2021-51;2;ALL
Portugal;PRT;10298252;cases;149656;113;2021-52;2003.47593;20.00339475;1437823;18999;1221;1308;Portugal2021-52;0;ALL
Portugal;PRT;10298252;cases;237019;133;2022-01;3754.76343;23.88754907;1674842;19132;1236;1216;Portugal2022-01;0;ALL
Portugal;PRT;10298252;cases;266047;205;2022-02;4884.964944;32.82110401;1940889;19337;1275;1272;Portugal2022-02;1167;ALL
Portugal;PRT;10298252;cases;368643;280;2022-03;6163.084764;47.09537114;2309532;19617;1422;1366;Portugal2022-03;3437;ALL
Portugal;PRT;10298252;cases;406242;291;2022-04;7524.432302;55.44630293;2715774;19908;1440;1345;Portugal2022-04;0;ALL
Portugal;PRT;10298252;cases;309097;355;2022-05;6946.217669;62.72909228;3024871;20263;1475;1393;Portugal2022-05;1648;ALL
Portugal;PRT;10298252;cases;170903;300;2022-06;4660.985185;63.603027;3195774;20563;1357;1337;Portugal2022-06;1;ALL
Portugal;PRT;10298252;cases;106789;298;2022-07;2696.496454;58.06810709;3302563;20861;1389;1303;Portugal2022-07;56;ALL
Portugal;PRT;10298252;cases;80792;202;2022-08;1821.483879;48.55192901;3383355;21063;1210;1254;Portugal2022-08;0;ALL
Portugal;PRT;10298252;cases;82773;153;2022-09;1588.279254;34.47186959;3466128;21216;1202;1181;Portugal2022-09;11;ALL
Portugal;PRT;10298252;cases;86062;140;2022-10;1639.452987;28.4514304;3552190;21356;1235;1198;Portugal2022-10;98;ALL
Portugal;PRT;10298252;cases;81692;126;2022-11;1628.95606;25.82962623;3633882;21482;1200;1210;Portugal2022-11;0;ALL
Portugal;PRT;10298252;cases;77615;158;2022-12;1546.932431;27.57749568;3711497;21640;1188;1238;Portugal2022-12;1;ALL
Portugal;PRT;10298252;cases;68463;150;2022-13;1418.473737;29.90798827;3779960;21790;1218;1238;Portugal2022-13;18;ALL
Portugal;PRT;10298252;cases;63339;151;2022-14;1279.848269;29.22826126;3843299;21941;1163;1238;Portugal2022-14;0;ALL
Portugal;PRT;10298252;cases;63993;145;2022-15;1236.442845;28.74274197;3907292;22086;1158;1265;Portugal2022-15;5;ALL
Portugal;PRT;10298252;cases;70580;126;2022-16;1306.755748;26.31514552;3977872;22212;1107;1185;Portugal2022-16;811;ALL
Portugal;PRT;10298252;cases;74771;128;2022-17;1411.414287;24.66437994;4052643;22340;1097;1162;Portugal2022-17;1;ALL
Portugal;PRT;10298252;cases;101268;131;2022-18;1709.406606;25.14989923;4153911;22471;1072;1127;Portugal2022-18;21;ALL
Portugal;PRT;10298252;cases;160412;192;2022-19;2541.013757;31.36454614;4314323;22663;1172;1244;Portugal2022-19;352;ALL
Portugal;PRT;10298252;cases;190521;222;2022-20;3407.69482;40.20099722;4504844;22885;:;:;Portugal2022-20;0;ALL
Portugal;PRT;10298252;cases;174979;230;2022-21;3549.14601;43.89094382;4679823;23115;:;:;Portugal2022-21;0;ALL
Portugal;PRT;10298252;cases;165149;291;2022-22;3302.774102;50.59111003;4844972;23406;:;:;Portugal2022-22;0;
